ID,NOREK,TGL_TRAN,TGL_EFEKTIF,JAM_TRAN,SEQ,DESK_TRAN,SALDO_AWAL_MUTASI,MUTASI_DEBET,MUTASI_KREDIT,SALDO_AKHIR_MUTASI,GLSIGN,TRUSER,KODE_TRAN,KODE_TRAN_TELLER,TRREMK,TLBDS1,TLBDS2,REMARK_CUSTOM
1,12301083861508,2024-01-02 06:41:00,1/2/2024 0:00,64155,41291,BFST0113340691100 NBMB:PDJBIDJA 20240102BRINIDJA010O0202060280 ESB:NBMB:0008G00F:630351115728,1687000,680000,0,1007000,Db,8888278,2,9973,BFST0113340691100 NBMB:PDJBIDJA,ESB:NBMB:0008G00F:630351115728,20240102BRINIDJA010O0202060280,BFST0113340691100 NBMB:PDJBIDJA
2,12301083861508,2024-01-02 06:41:04,1/2/2024 0:00,64155,41291,BFST0113340691100 NBMB:PDJBIDJA 20240102BRINIDJA010O0202060280 ESB:NBMB:0008G00F:630351115728,1007000,2500,0,1004500,Db,8888278,2,9973,BFST0113340691100 NBMB:PDJBIDJA,ESB:NBMB:0008G00F:630351115728,20240102BRINIDJA010O0202060280,BFST0113340691100 NBMB:PDJBIDJA
3,12301083861508,2024-01-02 11:11:00,1/2/2024 0:00,111139,184300,PUL-SIM 081286178536NBMB5221840817338040 ESB:NBMB:0100101C:630454017493,1004500,100000,0,904500,Db,8888597,2,8508,PUL-SIM 081286178536NBMB5221840817338040,ESB:NBMB:0100101C:630454017493,,Beli Pulsa Simpati 0812xxxx536 via BRImo
4,12301083861508,2024-01-02 11:11:04,1/2/2024 0:00,111139,184300,PUL-SIM 081286178536NBMB5221840817338040 ESB:NBMB:0100101C:630454017493,904500,1500,0,903000,Db,8888597,2,8508,PUL-SIM 081286178536NBMB5221840817338040,ESB:NBMB:0100101C:630454017493,,Beli Pulsa Simpati 0812xxxx536 via BRImo
5,12301083861508,2024-01-02 11:12:00,1/2/2024 0:00,111258,24351,PUL-SIM 081286178536NBMB5221840817338040 ESB:NBMB:0100101C:630454648676,903000,15000,0,888000,Db,8888163,2,8508,PUL-SIM 081286178536NBMB5221840817338040,ESB:NBMB:0100101C:630454648676,,Beli Pulsa Simpati 0812xxxx536 via BRImo
6,12301083861508,2024-01-02 11:12:04,1/2/2024 0:00,111258,24351,PUL-SIM 081286178536NBMB5221840817338040 ESB:NBMB:0100101C:630454648676,888000,1500,0,886500,Db,8888163,2,8508,PUL-SIM 081286178536NBMB5221840817338040,ESB:NBMB:0100101C:630454648676,,Beli Pulsa Simpati 0812xxxx536 via BRImo
7,12301083861508,2024-01-04 23:59:00,1/4/2024 0:00,235959,0,081286178536|1SMS|02/01/2024-02/01/2024,886500,500,0,886000,Db,DDY402,582,,081286178536|1SMS|02/01/2024-02/01/2024,,,Biaya SMS Notifikasi Sejumlah 1 Notifikasi
8,12301083861508,2024-01-11 13:25:00,1/11/2024 0:00,132522,344736,PLN-PRA 56019014093NBMB5221840817338040 ESB:NBMB:0400200T:634341709767,886000,50000,0,836000,Db,8888264,2,8508,PLN-PRA 56019014093NBMB5221840817338040,ESB:NBMB:0400200T:634341709767,,Beli Token PLN 56019014093 via BRImo
9,12301083861508,2024-01-11 13:25:04,1/11/2024 0:00,132522,344736,PLN-PRA 56019014093NBMB5221840817338040 ESB:NBMB:0400200T:634341709767,836000,3000,0,833000,Db,8888264,2,8508,PLN-PRA 56019014093NBMB5221840817338040,ESB:NBMB:0400200T:634341709767,,Beli Token PLN 56019014093 via BRImo
10,12301083861508,2024-01-15 10:47:00,1/15/2024 0:00,104706,63600,BFST6041060490 NBMB:CENAIDJA 20240115BRINIDJA010O0209593286 ESB:NBMB:0008G00F:635853411683,833000,368000,0,465000,Db,8888142,2,9973,BFST6041060490 NBMB:CENAIDJA,ESB:NBMB:0008G00F:635853411683,20240115BRINIDJA010O0209593286,BFST6041060490 NBMB:CENAIDJA
11,12301083861508,2024-01-15 10:47:04,1/15/2024 0:00,104706,63600,BFST6041060490 NBMB:CENAIDJA 20240115BRINIDJA010O0209593286 ESB:NBMB:0008G00F:635853411683,465000,2500,0,462500,Db,8888142,2,9973,BFST6041060490 NBMB:CENAIDJA,ESB:NBMB:0008G00F:635853411683,20240115BRINIDJA010O0209593286,BFST6041060490 NBMB:CENAIDJA
12,12301083861508,2024-01-19 08:28:00,1/19/2024 0:00,82822,82098,BRIVA88810089609954495NBMBDNID YESXXX AD BRIVA 88810089609954495NBMBDNID YESXXX A ESB:NBMB:0200200P:637489267755,462500,33500,0,429000,Db,8888530,4,6669,BRIVA88810089609954495NBMBDNID YESXXX AD,ESB:NBMB:0200200P:637489267755,BRIVA 88810089609954495NBMBDNID YESXXX A,Top Up DANA YESXXX AD 0896xxxx495 via BRImo
13,12301083861508,2024-01-20 00:00:00,1/20/2024 0:00,0,0,Biaya Bulanan ATM,429000,1000,0,428000,Db,,452,,,,,Biaya Bulanan ATM
14,12301083861508,2024-01-20 23:59:00,1/20/2024 0:00,235959,0,Biaya Administrasi,428000,6000,0,422000,Db,,453,,,,,Biaya Administrasi
15,12301083861508,2024-01-23 07:40:00,1/23/2024 0:00,74045,5084097,EDC DEYA DAMAYANTI TO ALUSTINA SUCI M FROM432901018417534 TO012301083861508EDC,422000,0,5000000,5422000,Cr,852416,1,8506,EDC DEYA DAMAYANTI TO ALUSTINA SUCI M,FROM432901018417534 TO012301083861508EDC,,Transfer Dari Deya Damayanti via EDC
16,12301083861508,2024-01-23 12:07:00,1/23/2024 0:00,120706,5989475,EDC DEYA DAMAYANTI TO ALUSTINA SUCI M FROM432901018417534 TO012301083861508EDC,5422000,0,500000,5922000,Cr,852416,1,8506,EDC DEYA DAMAYANTI TO ALUSTINA SUCI M,FROM432901018417534 TO012301083861508EDC,,Transfer Dari Deya Damayanti via EDC
17,12301083861508,2024-01-25 09:25:00,1/25/2024 0:00,92518,3855100,6.01301E+27,5922000,3000000,0,2922000,Db,888325,2,9992,6.01301E+27,,,6.01301E+27
18,12301083861508,2024-01-25 09:27:00,1/25/2024 0:00,92718,4232334,6.01301E+27,2922000,2800000,0,122000,Db,888316,2,9992,6.01301E+27,,,6.01301E+27
19,12301083861508,2024-01-26 09:48:00,1/26/2024 0:00,94824,3077,NBMB ALUSTINA SUCI TO TEDI ALAMSYAH ESB:NBMB:0001500F:640387282908,122000,50000,0,72000,Db,8888471,2,8506,NBMB ALUSTINA SUCI TO TEDI ALAMSYAH,ESB:NBMB:0001500F:640387282908,,Transfer Ke Tedi Alamsyah via BRImo
20,12301083861508,2024-01-28 23:59:00,1/28/2024 0:00,235959,0,081286178536|4SMS|23/01/2024-25/01/2024,72000,2000,0,70000,Db,DDY402,582,,081286178536|4SMS|23/01/2024-25/01/2024,,,Biaya SMS Notifikasi Sejumlah 4 Notifikasi
"1","12301083861508","2024-02-02 10:56:03","2024-02-02 00:00:00","105603","7395456","WBNKSTOR439301008245538TO012301083861508 ESB:WBNK:0303A00F:506362995779","70000.00",".00","1200000.00","1270000.00","Cr","0888122","1","8506","WBNKSTOR439301008245538TO012301083861508","ESB:WBNK:0303A00F:506362995779","","WBNKSTOR439301008245538TO012301083861508"
"2","12301083861508","2024-02-02 19:46:31","2024-02-02 00:00:00","194631","92708","BFST0113340691100 NBMB:PDJBIDJA 20240202BRINIDJA010O0209833708 ESB:NBMB:0008G00F:643673115852","1270000.00","680000.00",".00","590000.00","Db","8888257","2","9973","BFST0113340691100 NBMB:PDJBIDJA","ESB:NBMB:0008G00F:643673115852","20240202BRINIDJA010O0209833708","BFST0113340691100 NBMB:PDJBIDJA"
"3","12301083861508","2024-02-02 19:46:31","2024-02-02 00:00:00","194631","92708","BFST0113340691100 NBMB:PDJBIDJA 20240202BRINIDJA010O0209833708 ESB:NBMB:0008G00F:643673115852","590000.00","2500.00",".00","587500.00","Db","8888257","2","9973","BFST0113340691100 NBMB:PDJBIDJA","ESB:NBMB:0008G00F:643673115852","20240202BRINIDJA010O0209833708","BFST0113340691100 NBMB:PDJBIDJA"
"4","12301083861508","2024-02-02 19:47:49","2024-02-02 00:00:00","194749","52685","PUL-SIM 081286178536NBMB5221840817338040 ESB:NBMB:0100101C:643673722995","587500.00","20000.00",".00","567500.00","Db","8888374","2","8508","PUL-SIM 081286178536NBMB5221840817338040","ESB:NBMB:0100101C:643673722995","","Beli Pulsa Simpati 0812xxxx536 via BRImo"
"5","12301083861508","2024-02-02 19:47:49","2024-02-02 00:00:00","194749","52685","PUL-SIM 081286178536NBMB5221840817338040 ESB:NBMB:0100101C:643673722995","567500.00","1500.00",".00","566000.00","Db","8888374","2","8508","PUL-SIM 081286178536NBMB5221840817338040","ESB:NBMB:0100101C:643673722995","","Beli Pulsa Simpati 0812xxxx536 via BRImo"
"6","12301083861508","2024-02-02 19:48:17","2024-02-02 00:00:00","194817","32650","PUL-SIM 081286178536NBMB5221840817338040 ESB:NBMB:0100101C:643673947597","566000.00","100000.00",".00","466000.00","Db","8888218","2","8508","PUL-SIM 081286178536NBMB5221840817338040","ESB:NBMB:0100101C:643673947597","","Beli Pulsa Simpati 0812xxxx536 via BRImo"
"7","12301083861508","2024-02-02 19:48:17","2024-02-02 00:00:00","194817","32650","PUL-SIM 081286178536NBMB5221840817338040 ESB:NBMB:0100101C:643673947597","466000.00","1500.00",".00","464500.00","Db","8888218","2","8508","PUL-SIM 081286178536NBMB5221840817338040","ESB:NBMB:0100101C:643673947597","","Beli Pulsa Simpati 0812xxxx536 via BRImo"
"8","12301083861508","2024-02-04 23:59:59","2024-02-04 00:00:00","235959","0","081286178536|2SMS|02/02/2024-02/02/2024","464500.00","1000.00",".00","463500.00","Db","DDY402","582","","081286178536|2SMS|02/02/2024-02/02/2024","","","Biaya SMS Notifikasi Sejumlah 2 Notifikasi"
"9","12301083861508","2024-02-09 10:57:42","2024-02-09 00:00:00","105742","123667","BRIVA88810083841385705NBMBDNID CAHXX NUR BRIVA 88810083841385705NBMBDNID CAHXX NU ESB:NBMB:0200200P:646337321236","463500.00","100000.00",".00","363500.00","Db","8888068","4","6669","BRIVA88810083841385705NBMBDNID CAHXX NUR","ESB:NBMB:0200200P:646337321236","BRIVA 88810083841385705NBMBDNID CAHXX NU","Top Up DANA CAHXX NUR 0838xxxx705 via BRImo"
"10","12301083861508","2024-02-12 17:16:32","2024-02-12 00:00:00","171632","129565","BRIVA88810008561213099NBMBDNID 085612130 BRIVA 88810008561213099NBMBDNID 08561213 ESB:NBMB:0200200P:647549018921","363500.00","200000.00",".00","163500.00","Db","8888360","4","6669","BRIVA88810008561213099NBMBDNID 085612130","ESB:NBMB:0200200P:647549018921","BRIVA 88810008561213099NBMBDNID 08561213","Top Up DANA 085612130 0085xxxx099 via BRImo"
"11","12301083861508","2024-02-13 21:27:44","2024-02-13 00:00:00","212744","7007857","DANA20240213016467146575CAHYANURLELA WS_OB;20240213016467146575;72133 ESB:T:0371868:S:0371892:WSOB","163500.00",".00","100000.00","263500.00","Cr","0371868","5","8700","DANA20240213016467146575CAHYANURLELA","ESB:T:0371868:S:0371892:WSOB","WS_OB;20240213016467146575;72133","DANA20240213016467146575CAHYANURLELA"
"12","12301083861508","2024-02-15 17:43:55","2024-02-15 00:00:00","174355","28047","BFST901625772352 NBMB:SSPIIDJA 20240215BRINIDJA010O0247324612 ESB:NBMB:0008G00F:648605778956","263500.00","150000.00",".00","113500.00","Db","8888231","2","9973","BFST901625772352 NBMB:SSPIIDJA","ESB:NBMB:0008G00F:648605778956","20240215BRINIDJA010O0247324612","BFST901625772352 NBMB:SSPIIDJA"
"13","12301083861508","2024-02-15 17:43:55","2024-02-15 00:00:00","174355","28047","BFST901625772352 NBMB:SSPIIDJA 20240215BRINIDJA010O0247324612 ESB:NBMB:0008G00F:648605778956","113500.00","2500.00",".00","111000.00","Db","8888231","2","9973","BFST901625772352 NBMB:SSPIIDJA","ESB:NBMB:0008G00F:648605778956","20240215BRINIDJA010O0247324612","BFST901625772352 NBMB:SSPIIDJA"
"14","12301083861508","2024-02-18 11:44:53","2024-02-18 00:00:00","114453","5521423","EDC DEYA DAMAYANTI TO ALUSTINA SUCI M FROM432901018417534 TO012301083861508EDC","111000.00",".00","400000.00","511000.00","Cr","0852416","1","8506","EDC DEYA DAMAYANTI TO ALUSTINA SUCI M","FROM432901018417534 TO012301083861508EDC","","Transfer Dari Deya Damayanti via EDC"
"15","12301083861508","2024-02-19 16:39:28","2024-02-19 00:00:00","163928","8485","PLN-PRA 56019014093NBMB5221840817338040 ESB:NBMB:0400200T:650087890527","511000.00","50000.00",".00","461000.00","Db","8888581","2","8508","PLN-PRA 56019014093NBMB5221840817338040","ESB:NBMB:0400200T:650087890527","","Beli Token PLN 56019014093 via BRImo"
"16","12301083861508","2024-02-19 16:39:28","2024-02-19 00:00:00","163928","8485","PLN-PRA 56019014093NBMB5221840817338040 ESB:NBMB:0400200T:650087890527","461000.00","3000.00",".00","458000.00","Db","8888581","2","8508","PLN-PRA 56019014093NBMB5221840817338040","ESB:NBMB:0400200T:650087890527","","Beli Token PLN 56019014093 via BRImo"
"17","12301083861508","2024-02-20 00:00:00","2024-02-20 00:00:00","0","0","Biaya Bulanan ATM","458000.00","1000.00",".00","457000.00","Db","","452","","","","","Biaya Bulanan ATM"
"18","12301083861508","2024-02-20 23:59:59","2024-02-20 00:00:00","235959","0","Biaya Administrasi","457000.00","6000.00",".00","451000.00","Db","","453","","","","","Biaya Administrasi"
"19","12301083861508","2024-02-21 13:23:03","2024-02-21 00:00:00","132303","65982","BRIVA88810081219170019NBMBDNID NAJXX ALF BRIVA 88810081219170019NBMBDNID NAJXX AL ESB:NBMB:0200200P:650854962581","451000.00","200000.00",".00","251000.00","Db","8888452","4","6669","BRIVA88810081219170019NBMBDNID NAJXX ALF","ESB:NBMB:0200200P:650854962581","BRIVA 88810081219170019NBMBDNID NAJXX AL","Top Up DANA NAJXX ALF 0812xxxx019 via BRImo"
"20","12301083861508","2024-02-24 09:05:37","2024-02-24 00:00:00","90537","4674089","WBNK DEYA DAMAYANTI TO TO ALUSTINA SUCI FROM432901018417534 TO012301083861508WBN","251000.00",".00","200000.00","451000.00","Cr","0888128","1","8506","WBNK DEYA DAMAYANTI TO TO ALUSTINA SUCI","FROM432901018417534 TO012301083861508WBN","","Transfer Dari Deya Damayanti via BRILink"
"21","12301083861508","2024-02-27 09:55:22","2024-02-27 00:00:00","95522","3258","BRIVA88810088299538305NBMBDNID RISXX AUL BRIVA 88810088299538305NBMBDNID RISXX AU ESB:NBMB:0200200P:653091082122","451000.00","200000.00",".00","251000.00","Db","8888460","4","6669","BRIVA88810088299538305NBMBDNID RISXX AUL","ESB:NBMB:0200200P:653091082122","BRIVA 88810088299538305NBMBDNID RISXX AU","Top Up DANA RISXX AUL 0882xxxx305 via BRImo"
"1","12301083861508","2024-03-01 14:46:36","2024-03-01 00:00:00","144636","9645652","WBNK DEYA DAMAYANTI TO TO ALUSTINA SUCI FROM432901018417534 TO012301083861508WBN","251000.00",".00","1200000.00","1451000.00","Cr","0888907","1","8506","WBNK DEYA DAMAYANTI TO TO ALUSTINA SUCI","FROM432901018417534 TO012301083861508WBN","","Transfer Dari Deya Damayanti via BRILink"
"2","12301083861508","2024-03-02 08:15:55","2024-03-02 00:00:00","81555","22594","BFST0113340691100 NBMB:PDJBIDJA 20240302BRINIDJA010O0247637261 ESB:NBMB:0008G00F:654865772322","1451000.00","680000.00",".00","771000.00","Db","8888031","2","9973","BFST0113340691100 NBMB:PDJBIDJA","ESB:NBMB:0008G00F:654865772322","20240302BRINIDJA010O0247637261","BFST0113340691100 NBMB:PDJBIDJA"
"3","12301083861508","2024-03-02 08:15:55","2024-03-02 00:00:00","81555","22594","BFST0113340691100 NBMB:PDJBIDJA 20240302BRINIDJA010O0247637261 ESB:NBMB:0008G00F:654865772322","771000.00","2500.00",".00","768500.00","Db","8888031","2","9973","BFST0113340691100 NBMB:PDJBIDJA","ESB:NBMB:0008G00F:654865772322","20240302BRINIDJA010O0247637261","BFST0113340691100 NBMB:PDJBIDJA"
"4","12301083861508","2024-03-03 14:34:02","2024-03-03 00:00:00","143402","6805","PUL-SIM 081286178536NBMB5221840817338040 ESB:NBMB:0100101C:655417322631","768500.00","15000.00",".00","753500.00","Db","8888316","2","8508","PUL-SIM 081286178536NBMB5221840817338040","ESB:NBMB:0100101C:655417322631","","Beli Pulsa Simpati 0812xxxx536 via BRImo"
"5","12301083861508","2024-03-03 14:34:02","2024-03-03 00:00:00","143402","6805","PUL-SIM 081286178536NBMB5221840817338040 ESB:NBMB:0100101C:655417322631","753500.00","1500.00",".00","752000.00","Db","8888316","2","8508","PUL-SIM 081286178536NBMB5221840817338040","ESB:NBMB:0100101C:655417322631","","Beli Pulsa Simpati 0812xxxx536 via BRImo"
"6","12301083861508","2024-03-03 14:34:34","2024-03-03 00:00:00","143434","6784","PUL-SIM 081286178536NBMB5221840817338040 ESB:NBMB:0100101C:655417498488","752000.00","100000.00",".00","652000.00","Db","8888181","2","8508","PUL-SIM 081286178536NBMB5221840817338040","ESB:NBMB:0100101C:655417498488","","Beli Pulsa Simpati 0812xxxx536 via BRImo"
"7","12301083861508","2024-03-03 14:34:34","2024-03-03 00:00:00","143434","6784","PUL-SIM 081286178536NBMB5221840817338040 ESB:NBMB:0100101C:655417498488","652000.00","1500.00",".00","650500.00","Db","8888181","2","8508","PUL-SIM 081286178536NBMB5221840817338040","ESB:NBMB:0100101C:655417498488","","Beli Pulsa Simpati 0812xxxx536 via BRImo"
"8","12301083861508","2024-03-04 07:42:34","2024-03-04 00:00:00","74234","61901","BRIVA88810088299538305NBMBDNID RISXX AUL BRIVA 88810088299538305NBMBDNID RISXX AU ESB:NBMB:0200200P:655660605435","650500.00","200000.00",".00","450500.00","Db","8888555","4","6669","BRIVA88810088299538305NBMBDNID RISXX AUL","ESB:NBMB:0200200P:655660605435","BRIVA 88810088299538305NBMBDNID RISXX AU","Top Up DANA RISXX AUL 0882xxxx305 via BRImo"
"9","12301083861508","2024-03-04 23:59:59","2024-03-04 00:00:00","235959","0","081286178536|2SMS|01/03/2024-02/03/2024","450500.00","1500.00",".00","449000.00","Db","DDY402","582","","081286178536|2SMS|01/03/2024-02/03/2024","","","Biaya SMS Notifikasi Sejumlah 2 Notifikasi"
"10","12301083861508","2024-03-05 22:05:12","2024-03-05 00:00:00","220512","7134494","DANA20240305016691544086NAJMAALFISYA WS_OB;20240305016691544086;72133 ESB:T:0371877:S:0371892:WSOB","449000.00",".00","20000.00","469000.00","Cr","0371877","5","8700","DANA20240305016691544086NAJMAALFISYA","ESB:T:0371877:S:0371892:WSOB","WS_OB;20240305016691544086;72133","DANA20240305016691544086NAJMAALFISYA"
"11","12301083861508","2024-03-07 12:06:44","2024-03-07 00:00:00","120644","105135","BRIVA88810088299538305NBMBDNID RISXX AUL BRIVA 88810088299538305NBMBDNID RISXX AU ESB:NBMB:0200200P:657086249365","469000.00","100000.00",".00","369000.00","Db","8888321","4","6669","BRIVA88810088299538305NBMBDNID RISXX AUL","ESB:NBMB:0200200P:657086249365","BRIVA 88810088299538305NBMBDNID RISXX AU","Top Up DANA RISXX AUL 0882xxxx305 via BRImo"
"12","12301083861508","2024-03-09 10:50:25","2024-03-09 00:00:00","105025","104880","BRIVA88810085641061574NBMBDNID RACXXX MU BRIVA 88810085641061574NBMBDNID RACXXX M ESB:NBMB:0200200P:657888258018","369000.00","20000.00",".00","349000.00","Db","8888252","4","6669","BRIVA88810085641061574NBMBDNID RACXXX MU","ESB:NBMB:0200200P:657888258018","BRIVA 88810085641061574NBMBDNID RACXXX M","Top Up DANA RACXXX MU 0856xxxx574 via BRImo"
"13","12301083861508","2024-03-13 14:38:40","2024-03-13 00:00:00","143840","126758","BRIVA88810083841385705NBMBDNID CAHXX NUR BRIVA 88810083841385705NBMBDNID CAHXX NU ESB:NBMB:0200200P:659434163859","349000.00","30500.00",".00","318500.00","Db","8888027","4","6669","BRIVA88810083841385705NBMBDNID CAHXX NUR","ESB:NBMB:0200200P:659434163859","BRIVA 88810083841385705NBMBDNID CAHXX NU","Top Up DANA CAHXX NUR 0838xxxx705 via BRImo"
"14","12301083861508","2024-03-20 00:00:00","2024-03-20 00:00:00","0","0","Monthly Fee ATM","318500.00","1000.00",".00","317500.00","Db","","452","","","","","Monthly Fee ATM"
"15","12301083861508","2024-03-20 23:59:59","2024-03-20 00:00:00","235959","0","Admin Fee","317500.00","6000.00",".00","311500.00","Db","","453","","","","","Admin Fee"
"16","12301083861508","2024-03-21 07:01:53","2024-03-21 00:00:00","70153","9894400","WBNK DEYA DAMAYANTI TO TO ALUSTINA SUCI FROM432901018417534 TO012301083861508WBN","311500.00",".00","200000.00","511500.00","Cr","0888005","1","8506","WBNK DEYA DAMAYANTI TO TO ALUSTINA SUCI","FROM432901018417534 TO012301083861508WBN","","Transfer Dari Deya Damayanti via BRILink"
"17","12301083861508","2024-03-22 09:09:58","2024-03-22 00:00:00","90958","123070","BRIVA88810081219170019NBMBDNID NAJXX ALF BRIVA 88810081219170019NBMBDNID NAJXX AL ESB:NBMB:0200200P:662749238128","511500.00","20500.00",".00","491000.00","Db","8888265","4","6669","BRIVA88810081219170019NBMBDNID NAJXX ALF","ESB:NBMB:0200200P:662749238128","BRIVA 88810081219170019NBMBDNID NAJXX AL","Top Up DANA NAJXX ALF 0812xxxx019 via BRImo"
"18","12301083861508","2024-03-23 10:20:39","2024-03-23 00:00:00","102039","9029207","WBNK DEYA DAMAYANTI TO TO ALUSTINA SUCI FROM432901018417534 TO012301083861508WBN","491000.00",".00","1000000.00","1491000.00","Cr","0888010","1","8506","WBNK DEYA DAMAYANTI TO TO ALUSTINA SUCI","FROM432901018417534 TO012301083861508WBN","","Transfer Dari Deya Damayanti via BRILink"
"19","12301083861508","2024-03-25 13:31:06","2024-03-25 00:00:00","133106","147684","BRIVA88810088299538305NBMBDNID RISXX AUL BRIVA 88810088299538305NBMBDNID RISXX AU ESB:NBMB:0200200P:664006669708","1491000.00","200000.00",".00","1291000.00","Db","8888300","4","6669","BRIVA88810088299538305NBMBDNID RISXX AUL","ESB:NBMB:0200200P:664006669708","BRIVA 88810088299538305NBMBDNID RISXX AU","Top Up DANA RISXX AUL 0882xxxx305 via BRImo"
"20","12301083861508","2024-03-26 21:49:00","2024-03-26 00:00:00","214900","33973","PLN-PRA 56019014093NBMB5221840817338040 ESB:NBMB:0400200T:664682802387","1291000.00","50000.00",".00","1241000.00","Db","8888196","2","8508","PLN-PRA 56019014093NBMB5221840817338040","ESB:NBMB:0400200T:664682802387","","Beli Token PLN 56019014093 via BRImo"
"21","12301083861508","2024-03-26 21:49:00","2024-03-26 00:00:00","214900","33973","PLN-PRA 56019014093NBMB5221840817338040 ESB:NBMB:0400200T:664682802387","1241000.00","3000.00",".00","1238000.00","Db","8888196","2","8508","PLN-PRA 56019014093NBMB5221840817338040","ESB:NBMB:0400200T:664682802387","","Beli Token PLN 56019014093 via BRImo"
"22","12301083861508","2024-03-28 23:59:59","2024-03-28 00:00:00","235959","0","081286178536|1SMS|23/03/2024-23/03/2024","1238000.00","750.00",".00","1237250.00","Db","DDY402","582","","081286178536|1SMS|23/03/2024-23/03/2024","","","Biaya SMS Notifikasi Sejumlah 1 Notifikasi"
"1","12301083861508","2024-04-01 21:36:29","2024-04-01 00:00:00","213629","78761","BFST1730012716560 NBMB:BMRIIDJA 20240401BRINIDJA010O0210532206 ESB:NBMB:0008G00F:667500011761","1237250.00","30000.00",".00","1207250.00","Db","8888298","2","9973","BFST1730012716560 NBMB:BMRIIDJA","ESB:NBMB:0008G00F:667500011761","20240401BRINIDJA010O0210532206","BFST1730012716560 NBMB:BMRIIDJA"
"2","12301083861508","2024-04-01 21:36:29","2024-04-01 00:00:00","213629","78761","BFST1730012716560 NBMB:BMRIIDJA 20240401BRINIDJA010O0210532206 ESB:NBMB:0008G00F:667500011761","1207250.00","2500.00",".00","1204750.00","Db","8888298","2","9973","BFST1730012716560 NBMB:BMRIIDJA","ESB:NBMB:0008G00F:667500011761","20240401BRINIDJA010O0210532206","BFST1730012716560 NBMB:BMRIIDJA"
"3","12301083861508","2024-04-02 05:28:33","2024-04-02 00:00:00","52833","1919","BFST0113340691100 NBMB:PDJBIDJA 20240402BRINIDJA010O0212541787 ESB:NBMB:0008G00F:667600950615","1204750.00","680000.00",".00","524750.00","Db","8888434","2","9973","BFST0113340691100 NBMB:PDJBIDJA","ESB:NBMB:0008G00F:667600950615","20240402BRINIDJA010O0212541787","BFST0113340691100 NBMB:PDJBIDJA"
"4","12301083861508","2024-04-02 05:28:33","2024-04-02 00:00:00","52833","1919","BFST0113340691100 NBMB:PDJBIDJA 20240402BRINIDJA010O0212541787 ESB:NBMB:0008G00F:667600950615","524750.00","2500.00",".00","522250.00","Db","8888434","2","9973","BFST0113340691100 NBMB:PDJBIDJA","ESB:NBMB:0008G00F:667600950615","20240402BRINIDJA010O0212541787","BFST0113340691100 NBMB:PDJBIDJA"
"5","12301083861508","2024-04-02 09:39:29","2024-04-02 00:00:00","93929","44507","PUL-SIM 081286178536NBMB5221840817338040 ESB:NBMB:0100101C:667675721170","522250.00","20000.00",".00","502250.00","Db","8888175","2","8508","PUL-SIM 081286178536NBMB5221840817338040","ESB:NBMB:0100101C:667675721170","","Beli Pulsa Simpati 0812xxxx536 via BRImo"
"6","12301083861508","2024-04-02 09:39:29","2024-04-02 00:00:00","93929","44507","PUL-SIM 081286178536NBMB5221840817338040 ESB:NBMB:0100101C:667675721170","502250.00","1500.00",".00","500750.00","Db","8888175","2","8508","PUL-SIM 081286178536NBMB5221840817338040","ESB:NBMB:0100101C:667675721170","","Beli Pulsa Simpati 0812xxxx536 via BRImo"
"7","12301083861508","2024-04-02 09:39:55","2024-04-02 00:00:00","93955","104449","PUL-SIM 081286178536NBMB5221840817338040 ESB:NBMB:0100101C:667675923240","500750.00","100000.00",".00","400750.00","Db","8888462","2","8508","PUL-SIM 081286178536NBMB5221840817338040","ESB:NBMB:0100101C:667675923240","","Beli Pulsa Simpati 0812xxxx536 via BRImo"
"8","12301083861508","2024-04-02 09:39:55","2024-04-02 00:00:00","93955","104449","PUL-SIM 081286178536NBMB5221840817338040 ESB:NBMB:0100101C:667675923240","400750.00","1500.00",".00","399250.00","Db","8888462","2","8508","PUL-SIM 081286178536NBMB5221840817338040","ESB:NBMB:0100101C:667675923240","","Beli Pulsa Simpati 0812xxxx536 via BRImo"
"9","12301083861508","2024-04-03 06:46:52","2024-04-03 00:00:00","64652","2613424","WBNK DEYA DAMAYANTI TO RTO ALUSTINA SUCI FROM432901018417534 TO012301083861508WBN","399250.00",".00","500000.00","899250.00","Cr","0888129","1","8506","WBNK DEYA DAMAYANTI TO RTO ALUSTINA SUCI","FROM432901018417534 TO012301083861508WBN","","Transfer Dari Deya Damayanti via BRILink"
"10","12301083861508","2024-04-03 18:27:13","2024-04-03 00:00:00","182713","52787","BRIVA88810085779048190NBMBDNID MISXXX AU BRIVA 88810085779048190NBMBDNID MISXXX A ESB:NBMB:0200200P:668447118271","899250.00","100500.00",".00","798750.00","Db","8888533","4","6669","BRIVA88810085779048190NBMBDNID MISXXX AU","ESB:NBMB:0200200P:668447118271","BRIVA 88810085779048190NBMBDNID MISXXX A","Top Up DANA MISXXX AU 0857xxxx190 via BRImo"
"11","12301083861508","2024-04-04 23:59:59","2024-04-04 00:00:00","235959","0","081286178536|1SMS|02/04/2024-02/04/2024","798750.00","750.00",".00","798000.00","Db","DDY402","582","","081286178536|1SMS|02/04/2024-02/04/2024","","","Biaya SMS Notifikasi Sejumlah 1 Notifikasi"
"12","12301083861508","2024-04-07 22:08:43","2024-04-07 00:00:00","220843","13343","BFST1730012716560 NBMB:BMRIIDJA 20240407BRINIDJA010O0226054613 ESB:NBMB:0008G00F:670521121918","798000.00","25000.00",".00","773000.00","Db","8888131","2","9973","BFST1730012716560 NBMB:BMRIIDJA","ESB:NBMB:0008G00F:670521121918","20240407BRINIDJA010O0226054613","BFST1730012716560 NBMB:BMRIIDJA"
"13","12301083861508","2024-04-07 22:08:43","2024-04-07 00:00:00","220843","13343","BFST1730012716560 NBMB:BMRIIDJA 20240407BRINIDJA010O0226054613 ESB:NBMB:0008G00F:670521121918","773000.00","2500.00",".00","770500.00","Db","8888131","2","9973","BFST1730012716560 NBMB:BMRIIDJA","ESB:NBMB:0008G00F:670521121918","20240407BRINIDJA010O0226054613","BFST1730012716560 NBMB:BMRIIDJA"
"14","12301083861508","2024-04-08 23:59:59","2024-04-08 00:00:00","235959","0","081286178536|1SMS|03/04/2024-03/04/2024","770500.00","750.00",".00","769750.00","Db","DDY402","582","","081286178536|1SMS|03/04/2024-03/04/2024","","","Biaya SMS Notifikasi Sejumlah 1 Notifikasi"
"15","12301083861508","2024-04-12 08:53:01","2024-04-12 00:00:00","85301","102236","NBMB DEYA DAMAYANTI TO ALUSTINA SUCI MAN ESB:NBMB:0001500F:672015337408","769750.00",".00","2000000.00","2769750.00","Cr","8888109","1","8506","NBMB DEYA DAMAYANTI TO ALUSTINA SUCI MAN","ESB:NBMB:0001500F:672015337408","","Transfer Dari Deya Damayanti via BRImo"
"16","12301083861508","2024-04-15 16:30:00","2024-04-15 00:00:00","163000","87162","BRIVA88810081219170019NBMBDNID NAJXX ALF BRIVA 88810081219170019NBMBDNID NAJXX AL ESB:NBMB:0200200P:673034634551","2769750.00","20500.00",".00","2749250.00","Db","8888231","4","6669","BRIVA88810081219170019NBMBDNID NAJXX ALF","ESB:NBMB:0200200P:673034634551","BRIVA 88810081219170019NBMBDNID NAJXX AL","Top Up DANA NAJXX ALF 0812xxxx019 via BRImo"
"17","12301083861508","2024-04-16 23:59:59","2024-04-16 00:00:00","235959","0","081286178536|1SMS|12/04/2024-12/04/2024","2749250.00","750.00",".00","2748500.00","Db","DDY402","582","","081286178536|1SMS|12/04/2024-12/04/2024","","","Biaya SMS Notifikasi Sejumlah 1 Notifikasi"
"18","12301083861508","2024-04-20 00:00:00","2024-04-20 00:00:00","0","0","Monthly Fee ATM","2748500.00","1000.00",".00","2747500.00","Db","","452","","","","","Monthly Fee ATM"
"19","12301083861508","2024-04-20 23:59:59","2024-04-20 00:00:00","235959","0","Admin Fee","2747500.00","6000.00",".00","2741500.00","Db","","453","","","","","Admin Fee"
"20","12301083861508","2024-04-26 21:01:52","2024-04-26 00:00:00","210152","132415","PUL-SIM 081286178536NBMB5221840817338040 ESB:NBMB:0100101C:677274693052","2741500.00","30000.00",".00","2711500.00","Db","8888588","2","8508","PUL-SIM 081286178536NBMB5221840817338040","ESB:NBMB:0100101C:677274693052","","Beli Pulsa Simpati 0812xxxx536 via BRImo"
"21","12301083861508","2024-04-26 21:01:52","2024-04-26 00:00:00","210152","132415","PUL-SIM 081286178536NBMB5221840817338040 ESB:NBMB:0100101C:677274693052","2711500.00","1500.00",".00","2710000.00","Db","8888588","2","8508","PUL-SIM 081286178536NBMB5221840817338040","ESB:NBMB:0100101C:677274693052","","Beli Pulsa Simpati 0812xxxx536 via BRImo"
"22","12301083861508","2024-04-29 01:08:26","2024-04-29 00:00:00","10826","100354","BRIVA88810081291125667NBMBDNID BUNXX SAT BRIVA 88810081291125667NBMBDNID BUNXX SA ESB:NBMB:0200200P:678030572516","2710000.00","164000.00",".00","2546000.00","Db","8888218","4","6669","BRIVA88810081291125667NBMBDNID BUNXX SAT","ESB:NBMB:0200200P:678030572516","BRIVA 88810081291125667NBMBDNID BUNXX SA","Top Up DANA BUNXX SAT 0812xxxx667 via BRImo"
"23","12301083861508","2024-04-29 08:25:21","2024-04-29 00:00:00","82521","42176","PUL-SIM 081286178536NBMB5221840817338040 ESB:NBMB:0100101C:678082481895","2546000.00","20000.00",".00","2526000.00","Db","8888318","2","8508","PUL-SIM 081286178536NBMB5221840817338040","ESB:NBMB:0100101C:678082481895","","Beli Pulsa Simpati 0812xxxx536 via BRImo"
"24","12301083861508","2024-04-29 08:25:21","2024-04-29 00:00:00","82521","42176","PUL-SIM 081286178536NBMB5221840817338040 ESB:NBMB:0100101C:678082481895","2526000.00","1500.00",".00","2524500.00","Db","8888318","2","8508","PUL-SIM 081286178536NBMB5221840817338040","ESB:NBMB:0100101C:678082481895","","Beli Pulsa Simpati 0812xxxx536 via BRImo"
"25","12301083861508","2024-04-29 08:25:54","2024-04-29 00:00:00","82554","122162","PUL-SIM 081286178536NBMB5221840817338040 ESB:NBMB:0100101C:678082655539","2524500.00","100000.00",".00","2424500.00","Db","8888552","2","8508","PUL-SIM 081286178536NBMB5221840817338040","ESB:NBMB:0100101C:678082655539","","Beli Pulsa Simpati 0812xxxx536 via BRImo"
"26","12301083861508","2024-04-29 08:25:54","2024-04-29 00:00:00","82554","122162","PUL-SIM 081286178536NBMB5221840817338040 ESB:NBMB:0100101C:678082655539","2424500.00","1500.00",".00","2423000.00","Db","8888552","2","8508","PUL-SIM 081286178536NBMB5221840817338040","ESB:NBMB:0100101C:678082655539","","Beli Pulsa Simpati 0812xxxx536 via BRImo"
"1","12301083861508","2024-05-02 11:32:03","2024-05-02 00:00:00","113203","85554","BFST0113340691100 NBMB:PDJBIDJA 20240502BRINIDJA010O0217634001 ESB:NBMB:0008G00F:679516838523","2423000.00","680000.00",".00","1743000.00","Db","8888401","2","9973","BFST0113340691100 NBMB:PDJBIDJA","ESB:NBMB:0008G00F:679516838523","20240502BRINIDJA010O0217634001","BFST0113340691100 NBMB:PDJBIDJA"
"2","12301083861508","2024-05-02 11:32:03","2024-05-02 00:00:00","113203","85554","BFST0113340691100 NBMB:PDJBIDJA 20240502BRINIDJA010O0217634001 ESB:NBMB:0008G00F:679516838523","1743000.00","2500.00",".00","1740500.00","Db","8888401","2","9973","BFST0113340691100 NBMB:PDJBIDJA","ESB:NBMB:0008G00F:679516838523","20240502BRINIDJA010O0217634001","BFST0113340691100 NBMB:PDJBIDJA"
"3","12301083861508","2024-05-04 18:00:13","2024-05-04 00:00:00","180013","89579","BRIVA88810085719578343NBMBDNID MEIXXX IR BRIVA 88810085719578343NBMBDNID MEIXXX I ESB:NBMB:0200200P:680526855577","1740500.00","200000.00",".00","1540500.00","Db","8888145","4","6669","BRIVA88810085719578343NBMBDNID MEIXXX IR","ESB:NBMB:0200200P:680526855577","BRIVA 88810085719578343NBMBDNID MEIXXX I","Top Up DANA MEIXXX IR 0857xxxx343 via BRImo"
"4","12301083861508","2024-05-04 19:30:17","2024-05-04 00:00:00","193017","0","081286178536|1SMS|02/05/2024-02/05/2024","1540500.00","750.00",".00","1539750.00","Db","BRIMDBT","582","","081286178536|1SMS|02/05/2024-02/05/2024","","","Biaya SMS Notifikasi Sejumlah 1 Notifikasi"
"5","12301083861508","2024-05-07 13:40:04","2024-05-07 00:00:00","134004","106527","BRIVA88810085779048190NBMBDNID MISXXX AU BRIVA 88810085779048190NBMBDNID MISXXX A ESB:NBMB:0200200P:681638831460","1539750.00","26500.00",".00","1513250.00","Db","8888019","4","6669","BRIVA88810085779048190NBMBDNID MISXXX AU","ESB:NBMB:0200200P:681638831460","BRIVA 88810085779048190NBMBDNID MISXXX A","Top Up DANA MISXXX AU 0857xxxx190 via BRImo"
"6","12301083861508","2024-05-07 18:09:43","2024-05-07 00:00:00","180943","7105516","DANA20240507017363421871MUHAMADFAZRI WS_OB;20240507017363421871;72133 ESB:T:0371862:S:0371892:WSOB","1513250.00",".00","17000.00","1530250.00","Cr","0371862","5","8700","DANA20240507017363421871MUHAMADFAZRI","ESB:T:0371862:S:0371892:WSOB","WS_OB;20240507017363421871;72133","DANA20240507017363421871MUHAMADFAZRI"
"7","12301083861508","2024-05-08 18:31:17","2024-05-08 00:00:00","183117","90925","NBMB DEYA DAMAYANTI TO ALUSTINA SUCI MAN ESB:NBMB:0001500F:682168144083","1530250.00",".00","500000.00","2030250.00","Cr","8888264","1","8506","NBMB DEYA DAMAYANTI TO ALUSTINA SUCI MAN","ESB:NBMB:0001500F:682168144083","","Transfer Dari Deya Damayanti via BRImo"
"8","12301083861508","2024-05-09 14:54:07","2024-05-09 00:00:00","145407","4326253","6013011130242596000000006915","2030250.00","500000.00",".00","1530250.00","Db","0888290","2","9992","6013011130242596000000006915","","","6013011130242596000000006915"
"9","12301083861508","2024-05-09 14:54:07","2024-05-09 00:00:00","145407","4326253","6013011130242596000000006915","1530250.00","7500.00",".00","1522750.00","Db","0888290","2","9992","6013011130242596000000006915","","","6013011130242596000000006915"
"10","12301083861508","2024-05-09 17:50:06","2024-05-09 00:00:00","175006","89000","PLN-PRA 56019014093NBMB5221840817338040 ESB:NBMB:0400200T:682546367923","1522750.00","50000.00",".00","1472750.00","Db","8888181","2","8508","PLN-PRA 56019014093NBMB5221840817338040","ESB:NBMB:0400200T:682546367923","","Beli Token PLN 56019014093 via BRImo"
"11","12301083861508","2024-05-09 17:50:06","2024-05-09 00:00:00","175006","89000","PLN-PRA 56019014093NBMB5221840817338040 ESB:NBMB:0400200T:682546367923","1472750.00","3000.00",".00","1469750.00","Db","8888181","2","8508","PLN-PRA 56019014093NBMB5221840817338040","ESB:NBMB:0400200T:682546367923","","Beli Token PLN 56019014093 via BRImo"
"12","12301083861508","2024-05-10 10:48:06","2024-05-10 00:00:00","104806","62116","BFST012301083861508TEDI ALAMSYA:SSPIIDJA 20240510SSPIIDJA010O0204778808 ESB:BFST:0008N:20240510FASTIDJA010795715","1469750.00",".00","40000.00","1509750.00","Cr","8888634","1","8154","BFST012301083861508TEDI ALAMSYA:SSPIIDJA","ESB:BFST:0008N:20240510FASTIDJA010795715","20240510SSPIIDJA010O0204778808","BFST012301083861508TEDI ALAMSYA:SSPIIDJA"
"13","12301083861508","2024-05-12 19:10:49","2024-05-12 00:00:00","191049","0","081286178536|2SMS|08/05/2024-09/05/2024","1509750.00","1500.00",".00","1508250.00","Db","BRIMDBT","582","","081286178536|2SMS|08/05/2024-09/05/2024","","","Biaya SMS Notifikasi Sejumlah 2 Notifikasi"
"14","12301083861508","2024-05-14 10:37:42","2024-05-14 00:00:00","103742","83904","BRIVA88810081219170019NBMBDNID NAJXX ALF BRIVA 88810081219170019NBMBDNID NAJXX AL ESB:NBMB:0200200P:684279822399","1508250.00","20500.00",".00","1487750.00","Db","8888486","4","6669","BRIVA88810081219170019NBMBDNID NAJXX ALF","ESB:NBMB:0200200P:684279822399","BRIVA 88810081219170019NBMBDNID NAJXX AL","Top Up DANA NAJXX ALF 0812xxxx019 via BRImo"
"15","12301083861508","2024-05-14 16:23:12","2024-05-14 00:00:00","162312","128304","BRIVA88810085772497910NBMBDNID MUHXXXX F BRIVA 88810085772497910NBMBDNID MUHXXXX ESB:NBMB:0200200P:684407071671","1487750.00","100500.00",".00","1387250.00","Db","8888442","4","6669","BRIVA88810085772497910NBMBDNID MUHXXXX F","ESB:NBMB:0200200P:684407071671","BRIVA 88810085772497910NBMBDNID MUHXXXX","Top Up DANA MUHXXXX F 0857xxxx910 via BRImo"
"16","12301083861508","2024-05-15 22:31:07","2024-05-15 00:00:00","223107","16763","BRIVA88810083819258980NBMBDNID DARXX FAU BRIVA 88810083819258980NBMBDNID DARXX FA ESB:NBMB:0200200P:684961283137","1387250.00","200000.00",".00","1187250.00","Db","8888152","4","6669","BRIVA88810083819258980NBMBDNID DARXX FAU","ESB:NBMB:0200200P:684961283137","BRIVA 88810083819258980NBMBDNID DARXX FA","Top Up DANA DARXX FAU 0838xxxx980 via BRImo"
"17","12301083861508","2024-05-20 00:00:00","2024-05-20 00:00:00","0","0","Monthly Fee ATM","1187250.00","1000.00",".00","1186250.00","Db","","452","","","","","Monthly Fee ATM"
"18","12301083861508","2024-05-20 15:41:20","2024-05-20 00:00:00","154120","128067","BRIVA88810087856975466NBMBDNID ALLXX PUT BRIVA 88810087856975466NBMBDNID ALLXX PU ESB:NBMB:0200200P:686748265645","1186250.00","100000.00",".00","1086250.00","Db","8888214","4","6669","BRIVA88810087856975466NBMBDNID ALLXX PUT","ESB:NBMB:0200200P:686748265645","BRIVA 88810087856975466NBMBDNID ALLXX PU","Top Up DANA ALLXX PUT 0878xxxx466 via BRImo"
"19","12301083861508","2024-05-20 23:59:59","2024-05-20 00:00:00","235959","0","Admin Fee","1086250.00","6000.00",".00","1080250.00","Db","","453","","","","","Admin Fee"
"20","12301083861508","2024-05-25 15:33:52","2024-05-25 00:00:00","153352","127278","BRIVA88810081282093106NBMBDNID ANAXXX ZI BRIVA 88810081282093106NBMBDNID ANAXXX Z ESB:NBMB:0200200P:688731006472","1080250.00","20500.00",".00","1059750.00","Db","8888534","4","6669","BRIVA88810081282093106NBMBDNID ANAXXX ZI","ESB:NBMB:0200200P:688731006472","BRIVA 88810081282093106NBMBDNID ANAXXX Z","Top Up DANA ANAXXX ZI 0812xxxx106 via BRImo"
"21","12301083861508","2024-05-25 21:00:56","2024-05-25 00:00:00","210056","151843","NBMB ALUSTINA SUCI TO RATNA SUMINAR ESB:NBMB:0001500F:688859013121","1059750.00","100000.00",".00","959750.00","Db","8888371","2","8506","NBMB ALUSTINA SUCI TO RATNA SUMINAR","ESB:NBMB:0001500F:688859013121","","Transfer Ke Ratna Suminar via BRImo"
"22","12301083861508","2024-05-29 10:51:38","2024-05-29 00:00:00","105138","43841","BRIVA88810085776152269NBMBDNID SITX ZULX BRIVA 88810085776152269NBMBDNID SITX ZUL ESB:NBMB:0200200P:690174458145","959750.00","200000.00",".00","759750.00","Db","8888582","4","6669","BRIVA88810085776152269NBMBDNID SITX ZULX","ESB:NBMB:0200200P:690174458145","BRIVA 88810085776152269NBMBDNID SITX ZUL","Top Up DANA SITX ZULX 0857xxxx269 via BRImo"
"23","12301083861508","2024-05-31 07:18:30","2024-05-31 00:00:00","71830","41757","PUL-SIM 081286178536NBMB5221840817338040 ESB:NBMB:0100101C:690926169446","759750.00","20000.00",".00","739750.00","Db","8888244","2","8508","PUL-SIM 081286178536NBMB5221840817338040","ESB:NBMB:0100101C:690926169446","","Beli Pulsa Simpati 0812xxxx536 via BRImo"
"24","12301083861508","2024-05-31 07:18:30","2024-05-31 00:00:00","71830","41757","PUL-SIM 081286178536NBMB5221840817338040 ESB:NBMB:0100101C:690926169446","739750.00","1500.00",".00","738250.00","Db","8888244","2","8508","PUL-SIM 081286178536NBMB5221840817338040","ESB:NBMB:0100101C:690926169446","","Beli Pulsa Simpati 0812xxxx536 via BRImo"
"25","12301083861508","2024-05-31 07:18:54","2024-05-31 00:00:00","71854","1729","PUL-SIM 081286178536NBMB5221840817338040 ESB:NBMB:0100101C:690926274864","738250.00","100000.00",".00","638250.00","Db","8888099","2","8508","PUL-SIM 081286178536NBMB5221840817338040","ESB:NBMB:0100101C:690926274864","","Beli Pulsa Simpati 0812xxxx536 via BRImo"
"26","12301083861508","2024-05-31 07:18:54","2024-05-31 00:00:00","71854","1729","PUL-SIM 081286178536NBMB5221840817338040 ESB:NBMB:0100101C:690926274864","638250.00","1500.00",".00","636750.00","Db","8888099","2","8508","PUL-SIM 081286178536NBMB5221840817338040","ESB:NBMB:0100101C:690926274864","","Beli Pulsa Simpati 0812xxxx536 via BRImo"
"27","12301083861508","2024-05-31 09:40:53","2024-05-31 00:00:00","94053","63126","BRIVA88810088299538305NBMBDNID RISXX AUL BRIVA 88810088299538305NBMBDNID RISXX AU ESB:NBMB:0200200P:690974836642","636750.00","100000.00",".00","536750.00","Db","8888200","4","6669","BRIVA88810088299538305NBMBDNID RISXX AUL","ESB:NBMB:0200200P:690974836642","BRIVA 88810088299538305NBMBDNID RISXX AU","Top Up DANA RISXX AUL 0882xxxx305 via BRImo"
"1","12301083861508","2024-06-04 12:48:28","2024-06-04 00:00:00","124828","7063117","DANA20240604017648704286NAJMAALFISYA WS_OB;20240604017648704286;72133 ESB:T:0371850:S:0371892:WSOB","536750.00",".00","121000.00","657750.00","Cr","0371850","5","8700","DANA20240604017648704286NAJMAALFISYA","ESB:T:0371850:S:0371892:WSOB","WS_OB;20240604017648704286;72133","DANA20240604017648704286NAJMAALFISYA"
"2","12301083861508","2024-06-06 03:17:58","2024-06-06 00:00:00","31758","20811","BFST1730016378474 NBMB:BMRIIDJA 20240606BRINIDJA010O0234545384 ESB:NBMB:0008G00F:693665642534","657750.00","100500.00",".00","557250.00","Db","8888451","2","9973","BFST1730016378474 NBMB:BMRIIDJA","ESB:NBMB:0008G00F:693665642534","20240606BRINIDJA010O0234545384","BFST1730016378474 NBMB:BMRIIDJA"
"3","12301083861508","2024-06-06 03:17:58","2024-06-06 00:00:00","31758","20811","BFST1730016378474 NBMB:BMRIIDJA 20240606BRINIDJA010O0234545384 ESB:NBMB:0008G00F:693665642534","557250.00","2500.00",".00","554750.00","Db","8888451","2","9973","BFST1730016378474 NBMB:BMRIIDJA","ESB:NBMB:0008G00F:693665642534","20240606BRINIDJA010O0234545384","BFST1730016378474 NBMB:BMRIIDJA"
"4","12301083861508","2024-06-13 21:50:17","2024-06-13 00:00:00","215017","9006837","PLN-PRA 56019014093NBMB5221840817338040 ESB:NBMB:0400200T:696999025975","554750.00","50000.00",".00","504750.00","Db","8888549","2","8508","PLN-PRA 56019014093NBMB5221840817338040","ESB:NBMB:0400200T:696999025975","","Beli Token PLN 56019014093 via BRImo"
"5","12301083861508","2024-06-13 21:50:17","2024-06-13 00:00:00","215017","9006837","PLN-PRA 56019014093NBMB5221840817338040 ESB:NBMB:0400200T:696999025975","504750.00","3000.00",".00","501750.00","Db","8888549","2","8508","PLN-PRA 56019014093NBMB5221840817338040","ESB:NBMB:0400200T:696999025975","","Beli Token PLN 56019014093 via BRImo"
"6","12301083861508","2024-06-17 07:47:06","2024-06-17 00:00:00","74706","7040796","DANA20240617017772148195ERIEJUWITA WS_OB;20240617017772148195;72133 ESB:T:0371868:S:0371892:WSOB","501750.00",".00","44000.00","545750.00","Cr","0371868","5","8700","DANA20240617017772148195ERIEJUWITA","ESB:T:0371868:S:0371892:WSOB","WS_OB;20240617017772148195;72133","DANA20240617017772148195ERIEJUWITA"
"7","12301083861508","2024-06-20 00:00:00","2024-06-20 00:00:00","0","0","Monthly Fee ATM","545750.00","1000.00",".00","544750.00","Db","","452","","","","","Monthly Fee ATM"
"8","12301083861508","2024-06-20 23:59:59","2024-06-20 00:00:00","235959","0","Admin Fee","544750.00","6000.00",".00","538750.00","Db","","453","","","","","Admin Fee"
"9","12301083861508","2024-06-24 15:46:49","2024-06-24 00:00:00","154649","9066366","BRIVA88810895383360065NBMBDNID NISXX BRIVA 88810895383360065NBMBDNID NISXX ESB:NBMB:0200200P:700942279674","538750.00","45000.00",".00","493750.00","Db","8888333","4","6669","BRIVA88810895383360065NBMBDNID NISXX","ESB:NBMB:0200200P:700942279674","BRIVA 88810895383360065NBMBDNID NISXX","Top Up DANA NISXX 8953xxxx065 via BRImo"
"10","12301083861508","2024-06-29 07:26:39","2024-06-29 00:00:00","72639","7120958","DANA20240629017913396086NAJMAALFISYA WS_OB;20240629017913396086;72133 ESB:T:0371876:S:0371892:WSOB","493750.00",".00","45000.00","538750.00","Cr","0371876","5","8700","DANA20240629017913396086NAJMAALFISYA","ESB:T:0371876:S:0371892:WSOB","WS_OB;20240629017913396086;72133","DANA20240629017913396086NAJMAALFISYA"
"11","12301083861508","2024-06-30 21:01:15","2024-06-30 00:00:00","210115","9009869","BRIVA112087769274343NBMBfXXXXXXXXXXX1 BRIVA 112087769274343NBMBfXXXXXXXXXXX1 ESB:NBMB:0200200P:703548603649","538750.00","33000.00",".00","505750.00","Db","8888521","4","6669","BRIVA112087769274343NBMBfXXXXXXXXXXX1","ESB:NBMB:0200200P:703548603649","BRIVA 112087769274343NBMBfXXXXXXXXXXX1","Top Up Shopee  fXXXXXXXXXXX1 0877xxxx343 via BRImo"
"1","12301083861508","2024-07-01 06:46:35","2024-07-01 00:00:00","64635","9061696","PUL-SIM 081286178536NBMB5221840817338040 ESB:NBMB:0100101C:703654510503","505750.00","20000.00",".00","485750.00","Db","8888397","2","8508","PUL-SIM 081286178536NBMB5221840817338040","ESB:NBMB:0100101C:703654510503","","Beli Pulsa Simpati 0812xxxx536 via BRImo"
"2","12301083861508","2024-07-01 06:46:35","2024-07-01 00:00:00","64635","9061696","PUL-SIM 081286178536NBMB5221840817338040 ESB:NBMB:0100101C:703654510503","485750.00","1500.00",".00","484250.00","Db","8888397","2","8508","PUL-SIM 081286178536NBMB5221840817338040","ESB:NBMB:0100101C:703654510503","","Beli Pulsa Simpati 0812xxxx536 via BRImo"
"3","12301083861508","2024-07-01 06:46:58","2024-07-01 00:00:00","64658","9021730","PUL-SIM 081286178536NBMB5221840817338040 ESB:NBMB:0100101C:703654616331","484250.00","100000.00",".00","384250.00","Db","8888332","2","8508","PUL-SIM 081286178536NBMB5221840817338040","ESB:NBMB:0100101C:703654616331","","Beli Pulsa Simpati 0812xxxx536 via BRImo"
"4","12301083861508","2024-07-01 06:46:58","2024-07-01 00:00:00","64658","9021730","PUL-SIM 081286178536NBMB5221840817338040 ESB:NBMB:0100101C:703654616331","384250.00","1500.00",".00","382750.00","Db","8888332","2","8508","PUL-SIM 081286178536NBMB5221840817338040","ESB:NBMB:0100101C:703654616331","","Beli Pulsa Simpati 0812xxxx536 via BRImo"
"5","12301083861508","2024-07-02 06:51:09","2024-07-02 00:00:00","65109","7521570","WBNK DEYA DAMAYANTI TO TO ALUSTINA SUCI FROM346301031725533 TO012301083861508WBN","382750.00",".00","1000000.00","1382750.00","Cr","0888140","1","8506","WBNK DEYA DAMAYANTI TO TO ALUSTINA SUCI","FROM346301031725533 TO012301083861508WBN","","Transfer Dari Deya Damayanti via BRILink"
"6","12301083861508","2024-07-02 07:21:42","2024-07-02 00:00:00","72142","9061688","BFST0113340691100 NBMB:PDJBIDJA ESB:NBMB:0008G00F:704181350311","1382750.00","680000.00",".00","702750.00","Db","8888333","2","9973","BFST0113340691100 NBMB:PDJBIDJA","ESB:NBMB:0008G00F:704181350311","","BFST0113340691100 NBMB:PDJBIDJA"
"7","12301083861508","2024-07-02 07:21:42","2024-07-02 00:00:00","72142","9061688","BFST0113340691100 NBMB:PDJBIDJA ESB:NBMB:0008G00F:704181350311","702750.00","2500.00",".00","700250.00","Db","8888333","2","9973","BFST0113340691100 NBMB:PDJBIDJA","ESB:NBMB:0008G00F:704181350311","","BFST0113340691100 NBMB:PDJBIDJA"
"8","12301083861508","2024-07-04 19:25:42","2024-07-04 00:00:00","192542","0","081286178536|2SMS|02/07/2024-02/07/2024","700250.00","1500.00",".00","698750.00","Db","BRIMDBT","582","","081286178536|2SMS|02/07/2024-02/07/2024","","","Biaya SMS Notifikasi Sejumlah 2 Notifikasi"
"9","12301083861508","2024-07-13 08:55:04","2024-07-13 00:00:00","85504","7556545","EDC DODON BUDIANA TO ALUSTINA SUCI M FROM439301012167536 TO012301083861508EDC","698750.00",".00","7000000.00","7698750.00","Cr","0852541","1","8506","EDC DODON BUDIANA TO ALUSTINA SUCI M","FROM439301012167536 TO012301083861508EDC","","Transfer Dari Dodon Budiana via EDC"
"10","12301083861508","2024-07-16 19:10:03","2024-07-16 00:00:00","191003","0","081286178536|1SMS|13/07/2024-13/07/2024","7698750.00","750.00",".00","7698000.00","Db","BRIMDBT","582","","081286178536|1SMS|13/07/2024-13/07/2024","","","Biaya SMS Notifikasi Sejumlah 1 Notifikasi"
"11","12301083861508","2024-07-20 00:00:00","2024-07-20 00:00:00","0","0","Monthly Fee ATM","7698000.00","1000.00",".00","7697000.00","Db","","452","","","","","Monthly Fee ATM"
"12","12301083861508","2024-07-20 23:59:59","2024-07-20 00:00:00","235959","0","Admin Fee","7697000.00","6000.00",".00","7691000.00","Db","","453","","","","","Admin Fee"
"13","12301083861508","2024-07-21 19:47:37","2024-07-21 00:00:00","194737","145889","BRIVA88810083841385705NBMBDNID CAHXX NUR ESB:NBMB:0200200P:712071029920","7691000.00","150000.00",".00","7541000.00","Db","8888573","4","6669","BRIVA88810083841385705NBMBDNID CAHXX NUR","ESB:NBMB:0200200P:712071029920","","Top Up DANA CAHXX NUR 0838xxxx705 via BRImo"
"14","12301083861508","2024-07-22 10:17:18","2024-07-22 00:00:00","101718","9002882","PUL-SIM 081286178536NBMB5221840817338040 ESB:NBMB:0100101C:712236349452","7541000.00","20000.00",".00","7521000.00","Db","8888206","2","8508","PUL-SIM 081286178536NBMB5221840817338040","ESB:NBMB:0100101C:712236349452","","Beli Pulsa Simpati 0812xxxx536 via BRImo"
"15","12301083861508","2024-07-22 10:17:18","2024-07-22 00:00:00","101718","9002882","PUL-SIM 081286178536NBMB5221840817338040 ESB:NBMB:0100101C:712236349452","7521000.00","1500.00",".00","7519500.00","Db","8888206","2","8508","PUL-SIM 081286178536NBMB5221840817338040","ESB:NBMB:0100101C:712236349452","","Beli Pulsa Simpati 0812xxxx536 via BRImo"
"16","12301083861508","2024-07-22 10:17:53","2024-07-22 00:00:00","101753","9022884","PUL-SIM 081286178536NBMB5221840817338040 ESB:NBMB:0100101C:712236569116","7519500.00","100000.00",".00","7419500.00","Db","8888347","2","8508","PUL-SIM 081286178536NBMB5221840817338040","ESB:NBMB:0100101C:712236569116","","Beli Pulsa Simpati 0812xxxx536 via BRImo"
"17","12301083861508","2024-07-22 10:17:53","2024-07-22 00:00:00","101753","9022884","PUL-SIM 081286178536NBMB5221840817338040 ESB:NBMB:0100101C:712236569116","7419500.00","1500.00",".00","7418000.00","Db","8888347","2","8508","PUL-SIM 081286178536NBMB5221840817338040","ESB:NBMB:0100101C:712236569116","","Beli Pulsa Simpati 0812xxxx536 via BRImo"
"18","12301083861508","2024-07-22 10:23:31","2024-07-22 00:00:00","102331","22129","NBMB ALUSTINA SUCI TO WAHYU NIKEN WULAN ESB:NBMB:0001500F:712238687237","7418000.00","370000.00",".00","7048000.00","Db","8888263","2","8506","NBMB ALUSTINA SUCI TO WAHYU NIKEN WULAN","ESB:NBMB:0001500F:712238687237","","Transfer Ke Wahyu Niken Wulan via BRImo"
"19","12301083861508","2024-07-23 18:31:14","2024-07-23 00:00:00","183114","125668","NBMB NUR MUHAMMAD E TO ALUSTINA SUCI MAN ESB:NBMB:0001500F:712804979766","7048000.00",".00","150000.00","7198000.00","Cr","8888003","1","8506","NBMB NUR MUHAMMAD E TO ALUSTINA SUCI MAN","ESB:NBMB:0001500F:712804979766","","Transfer Dari Nur Muhammad E via BRImo"
"20","12301083861508","2024-07-24 15:11:54","2024-07-24 00:00:00","151154","9005929","BFST7770809341 NBMB:CENAIDJA ESB:NBMB:0008G00F:713104592345","7198000.00","250000.00",".00","6948000.00","Db","8888592","2","9973","BFST7770809341 NBMB:CENAIDJA","ESB:NBMB:0008G00F:713104592345","","BFST7770809341 NBMB:CENAIDJA"
"21","12301083861508","2024-07-24 15:11:54","2024-07-24 00:00:00","151154","9005929","BFST7770809341 NBMB:CENAIDJA ESB:NBMB:0008G00F:713104592345","6948000.00","2500.00",".00","6945500.00","Db","8888592","2","9973","BFST7770809341 NBMB:CENAIDJA","ESB:NBMB:0008G00F:713104592345","","BFST7770809341 NBMB:CENAIDJA"
"22","12301083861508","2024-07-25 11:03:12","2024-07-25 00:00:00","110312","9263436","NBMB ALUSTINA SUCI TO LIZA CANIA ESB:NBMB:0001500F:713416815976","6945500.00","150000.00",".00","6795500.00","Db","8888100","2","8506","NBMB ALUSTINA SUCI TO LIZA CANIA","ESB:NBMB:0001500F:713416815976","","Transfer Ke Liza Cania via BRImo"
"23","12301083861508","2024-07-28 08:29:46","2024-07-28 00:00:00","82946","7005256","WBNKSTOR439301012167536TO012301083861508 ESB:WBNK:0303A00F:509049401767","6795500.00",".00","1000000.00","7795500.00","Cr","0888122","1","8506","WBNKSTOR439301012167536TO012301083861508","ESB:WBNK:0303A00F:509049401767","","WBNKSTOR439301012167536TO012301083861508"
"24","12301083861508","2024-07-30 08:36:22","2024-07-30 00:00:00","83622","61860","BFST012301083861508ALFIA MEILAN:PDJBIDJA ESB:BFST:0008N:20240730FASTIDJA010625917","7795500.00",".00","1000000.00","8795500.00","Cr","8888630","1","8154","BFST012301083861508ALFIA MEILAN:PDJBIDJA","ESB:BFST:0008N:20240730FASTIDJA010625917","","BFST012301083861508ALFIA MEILAN:PDJBIDJA"
"25","12301083861508","2024-07-30 13:30:14","2024-07-30 00:00:00","133014","201422","6013011130242596000000000133","8795500.00","3000000.00",".00","5795500.00","Db","0888300","2","9992","6013011130242596000000000133","","","6013011130242596000000000133"
"26","12301083861508","2024-07-30 13:30:14","2024-07-30 00:00:00","133014","201422","6013011130242596000000000133","5795500.00","7500.00",".00","5788000.00","Db","0888300","2","9992","6013011130242596000000000133","","","6013011130242596000000000133"
"27","12301083861508","2024-07-30 13:31:08","2024-07-30 00:00:00","133108","189892","6013011130242596000000000135","5788000.00","3000000.00",".00","2788000.00","Db","0888289","2","9992","6013011130242596000000000135","","","6013011130242596000000000135"
"28","12301083861508","2024-07-30 13:31:08","2024-07-30 00:00:00","133108","189892","6013011130242596000000000135","2788000.00","7500.00",".00","2780500.00","Db","0888289","2","9992","6013011130242596000000000135","","","6013011130242596000000000135"
"29","12301083861508","2024-07-30 13:32:08","2024-07-30 00:00:00","133208","201447","6013011130242596000000000137","2780500.00","1000000.00",".00","1780500.00","Db","0888300","2","9992","6013011130242596000000000137","","","6013011130242596000000000137"
"30","12301083861508","2024-07-30 13:32:08","2024-07-30 00:00:00","133208","201447","6013011130242596000000000137","1780500.00","7500.00",".00","1773000.00","Db","0888300","2","9992","6013011130242596000000000137","","","6013011130242596000000000137"
"31","12301083861508","2024-07-31 19:00:40","2024-07-31 00:00:00","190040","0","081286178536|1SMS|28/07/2024-28/07/2024","1773000.00","750.00",".00","1772250.00","Db","BRIMDBT","582","","081286178536|1SMS|28/07/2024-28/07/2024","","","Biaya SMS Notifikasi Sejumlah 1 Notifikasi"
"1","12301083861508","2024-08-02 19:42:40","2024-08-02 00:00:00","194240","2305","601301113024259600094136","1772250.00","700000.00",".00","1072250.00","Db","9823117","2","2501","601301113024259600094136","","","601301113024259600094136"
"2","12301083861508","2024-08-04 19:26:10","2024-08-04 00:00:00","192610","0","081286178536|5SMS|30/07/2024-02/08/2024","1072250.00","3750.00",".00","1068500.00","Db","BRIMDBT","582","","081286178536|5SMS|30/07/2024-02/08/2024","","","Biaya SMS Notifikasi Sejumlah 5 Notifikasi"
"3","12301083861508","2024-08-06 12:28:30","2024-08-06 00:00:00","122830","5038","BFST012301083861508RIZAL ABROR :SYCAIDJ1 20240806SYCAIDJ1010O9901875282 ESB:BFST:0008N:20240806FASTIDJA010662940","1068500.00",".00","50000.00","1118500.00","Cr","8888672","1","8154","BFST012301083861508RIZAL ABROR :SYCAIDJ1","ESB:BFST:0008N:20240806FASTIDJA010662940","20240806SYCAIDJ1010O9901875282","BFST012301083861508RIZAL ABROR :SYCAIDJ1"
"4","12301083861508","2024-08-06 13:42:14","2024-08-06 00:00:00","134214","9027111","BRIVA88810081219170019NBMBDNID NAJXX ALF BRIVA 88810081219170019NBMBDNID NAJXX AL ESB:NBMB:0200200P:718589873789","1118500.00","20000.00",".00","1098500.00","Db","8888290","4","6669","BRIVA88810081219170019NBMBDNID NAJXX ALF","ESB:NBMB:0200200P:718589873789","BRIVA 88810081219170019NBMBDNID NAJXX AL","Top Up DANA NAJXX ALF 0812xxxx019 via BRImo"
"5","12301083861508","2024-08-08 10:35:44","2024-08-08 00:00:00","103544","22526","BRIVA112081286178536NBMBaXXXXXXXXXXi BRIVA 112081286178536NBMBaXXXXXXXXXXi ESB:NBMB:0200200P:719345564540","1098500.00","100000.00",".00","998500.00","Db","8888348","4","6669","BRIVA112081286178536NBMBaXXXXXXXXXXi","ESB:NBMB:0200200P:719345564540","BRIVA 112081286178536NBMBaXXXXXXXXXXi","Top Up Shopee  aXXXXXXXXXXi 0812xxxx536 via BRImo"
"6","12301083861508","2024-08-08 18:58:20","2024-08-08 00:00:00","185820","9009706","BRIVA112081286178536NBMBaXXXXXXXXXXi BRIVA 112081286178536NBMBaXXXXXXXXXXi ESB:NBMB:0200200P:719544354995","998500.00","30000.00",".00","968500.00","Db","8888176","4","6669","BRIVA112081286178536NBMBaXXXXXXXXXXi","ESB:NBMB:0200200P:719544354995","BRIVA 112081286178536NBMBaXXXXXXXXXXi","Top Up Shopee  aXXXXXXXXXXi 0812xxxx536 via BRImo"
"7","12301083861508","2024-08-09 06:39:51","2024-08-09 00:00:00","63951","66160","WBNK DEYA DAMAYANTI TO TO ALUSTINA SUCI FROM346301031725533 TO012301083861508WBN","968500.00",".00","2000000.00","2968500.00","Cr","0888136","1","8506","WBNK DEYA DAMAYANTI TO TO ALUSTINA SUCI","FROM346301031725533 TO012301083861508WBN","","Transfer Dari Deya Damayanti via BRILink"
"8","12301083861508","2024-08-11 13:21:22","2024-08-11 00:00:00","132122","9044710","QRIS720615248866#9360000210058176980 ESB:NBMB:0007I00P:720615248866","2968500.00","38000.00",".00","2930500.00","Db","8888428","2","8508","QRIS720615248866#9360000210058176980","ESB:NBMB:0007I00P:720615248866","QRIS720615248866#9360000210058176980","Bayar QRIS Non BRI Merchant: QRIS720615248866"
"9","12301083861508","2024-08-12 19:11:28","2024-08-12 00:00:00","191128","0","081286178536|1SMS|09/08/2024-09/08/2024","2930500.00","750.00",".00","2929750.00","Db","BRIMDBT","582","","081286178536|1SMS|09/08/2024-09/08/2024","","","Biaya SMS Notifikasi Sejumlah 1 Notifikasi"
"10","12301083861508","2024-08-14 19:47:50","2024-08-14 00:00:00","194750","31569","PUL-SIM 081286178536NBMB5221840817338040 ESB:NBMB:0100101C:721957150071","2929750.00","100000.00",".00","2829750.00","Db","8888298","2","8508","PUL-SIM 081286178536NBMB5221840817338040","ESB:NBMB:0100101C:721957150071","","Beli Pulsa Simpati 0812xxxx536 via BRImo"
"11","12301083861508","2024-08-14 19:47:50","2024-08-14 00:00:00","194750","31569","PUL-SIM 081286178536NBMB5221840817338040 ESB:NBMB:0100101C:721957150071","2829750.00","1500.00",".00","2828250.00","Db","8888298","2","8508","PUL-SIM 081286178536NBMB5221840817338040","ESB:NBMB:0100101C:721957150071","","Beli Pulsa Simpati 0812xxxx536 via BRImo"
"12","12301083861508","2024-08-14 19:48:19","2024-08-14 00:00:00","194819","111563","PUL-SIM 081286178536NBMB5221840817338040 ESB:NBMB:0100101C:721957353921","2828250.00","20000.00",".00","2808250.00","Db","8888250","2","8508","PUL-SIM 081286178536NBMB5221840817338040","ESB:NBMB:0100101C:721957353921","","Beli Pulsa Simpati 0812xxxx536 via BRImo"
"13","12301083861508","2024-08-14 19:48:19","2024-08-14 00:00:00","194819","111563","PUL-SIM 081286178536NBMB5221840817338040 ESB:NBMB:0100101C:721957353921","2808250.00","1500.00",".00","2806750.00","Db","8888250","2","8508","PUL-SIM 081286178536NBMB5221840817338040","ESB:NBMB:0100101C:721957353921","","Beli Pulsa Simpati 0812xxxx536 via BRImo"
"14","12301083861508","2024-08-14 22:38:56","2024-08-14 00:00:00","223856","53694","PLN-PRA 56019014093NBMB5221840817338040 ESB:NBMB:0400200T:722014763430","2806750.00","50000.00",".00","2756750.00","Db","8888172","2","8508","PLN-PRA 56019014093NBMB5221840817338040","ESB:NBMB:0400200T:722014763430","","Beli Token PLN 56019014093 via BRImo"
"15","12301083861508","2024-08-14 22:38:56","2024-08-14 00:00:00","223856","53694","PLN-PRA 56019014093NBMB5221840817338040 ESB:NBMB:0400200T:722014763430","2756750.00","3000.00",".00","2753750.00","Db","8888172","2","8508","PLN-PRA 56019014093NBMB5221840817338040","ESB:NBMB:0400200T:722014763430","","Beli Token PLN 56019014093 via BRImo"
"16","12301083861508","2024-08-15 17:39:32","2024-08-15 00:00:00","173932","188714","QRIS722299603229#9360000210058176980 ESB:NBMB:0007I00P:722299603229","2753750.00","126000.00",".00","2627750.00","Db","8888373","2","8508","QRIS722299603229#9360000210058176980","ESB:NBMB:0007I00P:722299603229","QRIS722299603229#9360000210058176980","Bayar QRIS Non BRI Merchant: QRIS722299603229"
"17","12301083861508","2024-08-16 14:08:27","2024-08-16 00:00:00","140827","9045712","BRIVA88810088299538305NBMBDNID RISXX AUL BRIVA 88810088299538305NBMBDNID RISXX AU ESB:NBMB:0200200P:722615173439","2627750.00","22000.00",".00","2605750.00","Db","8888424","4","6669","BRIVA88810088299538305NBMBDNID RISXX AUL","ESB:NBMB:0200200P:722615173439","BRIVA 88810088299538305NBMBDNID RISXX AU","Top Up DANA RISXX AUL 0882xxxx305 via BRImo"
"18","12301083861508","2024-08-16 15:30:48","2024-08-16 00:00:00","153048","9146225","BRIVA88810085776152269NBMBDNID SITX ZULX BRIVA 88810085776152269NBMBDNID SITX ZUL ESB:NBMB:0200200P:722645926194","2605750.00","21000.00",".00","2584750.00","Db","8888217","4","6669","BRIVA88810085776152269NBMBDNID SITX ZULX","ESB:NBMB:0200200P:722645926194","BRIVA 88810085776152269NBMBDNID SITX ZUL","Top Up DANA SITX ZULX 0857xxxx269 via BRImo"
"19","12301083861508","2024-08-17 12:54:21","2024-08-17 00:00:00","125421","573608","6013011130242596000000194814","2584750.00","500000.00",".00","2084750.00","Db","0888311","2","9992","6013011130242596000000194814","","","6013011130242596000000194814"
"20","12301083861508","2024-08-17 12:54:21","2024-08-17 00:00:00","125421","573608","6013011130242596000000194814","2084750.00","7500.00",".00","2077250.00","Db","0888311","2","9992","6013011130242596000000194814","","","6013011130242596000000194814"
"21","12301083861508","2024-08-18 00:05:55","2024-08-18 00:00:00","555","1227364","6048201625772352#080032961970#ATM #TRFLA TRF BERSAMA FROM TEDI ALAMSYAH LA 012301083861508ATM 6048201625772352","2077250.00",".00","150000.00","2227250.00","Cr","0888173","1","8514","6048201625772352#080032961970#ATM #TRFLA","LA 012301083861508ATM 6048201625772352","TRF BERSAMA FROM TEDI ALAMSYAH","Transfer Antar Bank Dari Tedi Alamsyah"
"22","12301083861508","2024-08-20 00:00:00","2024-08-20 00:00:00","0","0","Monthly Fee ATM","2227250.00","1000.00",".00","2226250.00","Db","","452","","","","","Monthly Fee ATM"
"23","12301083861508","2024-08-20 23:59:59","2024-08-20 00:00:00","235959","0","Admin Fee","2226250.00","6000.00",".00","2220250.00","Db","","453","","","","","Admin Fee"
"24","12301083861508","2024-08-23 18:56:35","2024-08-23 00:00:00","185635","250188","6013011130242596000000599717","2220250.00","200000.00",".00","2020250.00","Db","0888334","2","9992","6013011130242596000000599717","","","6013011130242596000000599717"
"25","12301083861508","2024-08-23 18:56:35","2024-08-23 00:00:00","185635","250188","6013011130242596000000599717","2020250.00","7500.00",".00","2012750.00","Db","0888334","2","9992","6013011130242596000000599717","","","6013011130242596000000599717"
"26","12301083861508","2024-08-24 16:36:40","2024-08-24 00:00:00","163640","7126358","DANA20240824018551960501ALUSTINASUCI WS_OB;20240824018551960501;72133 ESB:T:0371875:S:0371892:WSOB","2012750.00",".00","100000.00","2112750.00","Cr","0371875","5","8700","DANA20240824018551960501ALUSTINASUCI","ESB:T:0371875:S:0371892:WSOB","WS_OB;20240824018551960501;72133","DANA20240824018551960501ALUSTINASUCI"
"27","12301083861508","2024-08-31 18:49:10","2024-08-31 00:00:00","184910","26648","BRIVA88810081388665470NBMBDNID 0ZAHRA BRIVA 88810081388665470NBMBDNID 0ZAHRA ESB:NBMB:0200200P:728652213124","2112750.00","25000.00",".00","2087750.00","Db","8888180","4","6669","BRIVA88810081388665470NBMBDNID 0ZAHRA","ESB:NBMB:0200200P:728652213124","BRIVA 88810081388665470NBMBDNID 0ZAHRA","Top Up DANA 0ZAHRA 0813xxxx470 via BRImo"
"1","12301083861508","2024-09-02 07:44:48","2024-09-02 00:00:00","74448","21391","BFST0113340691100 NBMB:PDJBIDJA 20240902BRINIDJA010O0220823712 ESB:NBMB:0008G00F:729296207594","2087750.00","680000.00",".00","1407750.00","Db","8888438","2","9973","BFST0113340691100 NBMB:PDJBIDJA","ESB:NBMB:0008G00F:729296207594","20240902BRINIDJA010O0220823712","BFST0113340691100 NBMB:PDJBIDJA"
"2","12301083861508","2024-09-02 07:44:48","2024-09-02 00:00:00","74448","21391","BFST0113340691100 NBMB:PDJBIDJA 20240902BRINIDJA010O0220823712 ESB:NBMB:0008G00F:729296207594","1407750.00","2500.00",".00","1405250.00","Db","8888438","2","9973","BFST0113340691100 NBMB:PDJBIDJA","ESB:NBMB:0008G00F:729296207594","20240902BRINIDJA010O0220823712","BFST0113340691100 NBMB:PDJBIDJA"
"3","12301083861508","2024-09-04 17:44:21","2024-09-04 00:00:00","174421","106294","BRIVA88810081219170019NBMBDNID NAJXX ALF BRIVA 88810081219170019NBMBDNID NAJXX AL ESB:NBMB:0200200P:730473971577","1405250.00","80000.00",".00","1325250.00","Db","8888444","4","6669","BRIVA88810081219170019NBMBDNID NAJXX ALF","ESB:NBMB:0200200P:730473971577","BRIVA 88810081219170019NBMBDNID NAJXX AL","Top Up DANA NAJXX ALF 0812xxxx019 via BRImo"
"4","12301083861508","2024-09-04 19:26:09","2024-09-04 00:00:00","192609","0","081286178536|1SMS|02/09/2024-02/09/2024","1325250.00","750.00",".00","1324500.00","Db","BRIMDBT","582","","081286178536|1SMS|02/09/2024-02/09/2024","","","Biaya SMS Notifikasi Sejumlah 1 Notifikasi"
"5","12301083861508","2024-09-05 10:34:54","2024-09-05 00:00:00","103454","22667","BRIVA88810081286178536NBMBDNID ALUXXXXX BRIVA 88810081286178536NBMBDNID ALUXXXXX ESB:NBMB:0200200P:730742642029","1324500.00","100000.00",".00","1224500.00","Db","8888278","4","6669","BRIVA88810081286178536NBMBDNID ALUXXXXX","ESB:NBMB:0200200P:730742642029","BRIVA 88810081286178536NBMBDNID ALUXXXXX","Top Up DANA ALUXXXXX 0812xxxx536 via BRImo"
"6","12301083861508","2024-09-11 21:09:57","2024-09-11 00:00:00","210957","9050972","BRIVA88810081286178536NBMBDNID ALUXXXXX BRIVA 88810081286178536NBMBDNID ALUXXXXX ESB:NBMB:0200200P:733581185751","1224500.00","100000.00",".00","1124500.00","Db","8888304","4","6669","BRIVA88810081286178536NBMBDNID ALUXXXXX","ESB:NBMB:0200200P:733581185751","BRIVA 88810081286178536NBMBDNID ALUXXXXX","Top Up DANA ALUXXXXX 0812xxxx536 via BRImo"
"7","12301083861508","2024-09-12 15:15:38","2024-09-12 00:00:00","151538","84704","BFST1730016357049 NBMB:BMRIIDJA 20240912BRINIDJA010O0224040705 ESB:NBMB:0008G00F:733854171012","1124500.00","100000.00",".00","1024500.00","Db","8888109","2","9973","BFST1730016357049 NBMB:BMRIIDJA","ESB:NBMB:0008G00F:733854171012","20240912BRINIDJA010O0224040705","BFST1730016357049 NBMB:BMRIIDJA"
"8","12301083861508","2024-09-12 15:15:38","2024-09-12 00:00:00","151538","84704","BFST1730016357049 NBMB:BMRIIDJA 20240912BRINIDJA010O0224040705 ESB:NBMB:0008G00F:733854171012","1024500.00","2500.00",".00","1022000.00","Db","8888109","2","9973","BFST1730016357049 NBMB:BMRIIDJA","ESB:NBMB:0008G00F:733854171012","20240912BRINIDJA010O0224040705","BFST1730016357049 NBMB:BMRIIDJA"
"9","12301083861508","2024-09-12 21:59:00","2024-09-12 00:00:00","215900","108159","BRIVA30135081290930161NBMBCECEP SUPRIATN BRIVA 30135081290930161NBMBCECEP SUPRIAT ESB:NBMB:0200200P:734016185047","1022000.00","19800.00",".00","1002200.00","Db","8888035","4","6670","BRIVA30135081290930161NBMBCECEP SUPRIATN","ESB:NBMB:0200200P:734016185047","BRIVA 30135081290930161NBMBCECEP SUPRIAT","BRIVA30135081290930161NBMBCECEP SUPRIATN"
"10","12301083861508","2024-09-12 21:59:00","2024-09-12 00:00:00","215900","108159","BRIVA30135081290930161NBMBCECEP SUPRIATN BRIVA 30135081290930161NBMBCECEP SUPRIAT ESB:NBMB:0200200P:734016185047","1002200.00","1000.00",".00","1001200.00","Db","8888035","4","6670","BRIVA30135081290930161NBMBCECEP SUPRIATN","ESB:NBMB:0200200P:734016185047","BRIVA 30135081290930161NBMBCECEP SUPRIAT","BRIVA30135081290930161NBMBCECEP SUPRIATN"
"11","12301083861508","2024-09-13 10:08:16","2024-09-13 00:00:00","100816","142258","PUL-SIM 081286178536NBMB5221840817338040 ESB:NBMB:0100101C:734154007017","1001200.00","20000.00",".00","981200.00","Db","8888222","2","8508","PUL-SIM 081286178536NBMB5221840817338040","ESB:NBMB:0100101C:734154007017","","Beli Pulsa Simpati 0812xxxx536 via BRImo"
"12","12301083861508","2024-09-13 10:08:16","2024-09-13 00:00:00","100816","142258","PUL-SIM 081286178536NBMB5221840817338040 ESB:NBMB:0100101C:734154007017","981200.00","1500.00",".00","979700.00","Db","8888222","2","8508","PUL-SIM 081286178536NBMB5221840817338040","ESB:NBMB:0100101C:734154007017","","Beli Pulsa Simpati 0812xxxx536 via BRImo"
"13","12301083861508","2024-09-13 10:08:35","2024-09-13 00:00:00","100835","142279","PUL-SIM 081286178536NBMB5221840817338040 ESB:NBMB:0100101C:734154125828","979700.00","100000.00",".00","879700.00","Db","8888067","2","8508","PUL-SIM 081286178536NBMB5221840817338040","ESB:NBMB:0100101C:734154125828","","Beli Pulsa Simpati 0812xxxx536 via BRImo"
"14","12301083861508","2024-09-13 10:08:35","2024-09-13 00:00:00","100835","142279","PUL-SIM 081286178536NBMB5221840817338040 ESB:NBMB:0100101C:734154125828","879700.00","1500.00",".00","878200.00","Db","8888067","2","8508","PUL-SIM 081286178536NBMB5221840817338040","ESB:NBMB:0100101C:734154125828","","Beli Pulsa Simpati 0812xxxx536 via BRImo"
"15","12301083861508","2024-09-13 12:28:31","2024-09-13 00:00:00","122831","807564","6013011130242596000000006925","878200.00","200000.00",".00","678200.00","Db","0888316","2","9992","6013011130242596000000006925","","","6013011130242596000000006925"
"16","12301083861508","2024-09-16 10:21:55","2024-09-16 00:00:00","102155","62152","PLN-PRA 56019014093NBMB5221840817338040 ESB:NBMB:0400200T:735348999673","678200.00","50000.00",".00","628200.00","Db","8888426","2","8508","PLN-PRA 56019014093NBMB5221840817338040","ESB:NBMB:0400200T:735348999673","","Beli Token PLN 56019014093 via BRImo"
"17","12301083861508","2024-09-16 10:21:55","2024-09-16 00:00:00","102155","62152","PLN-PRA 56019014093NBMB5221840817338040 ESB:NBMB:0400200T:735348999673","628200.00","3000.00",".00","625200.00","Db","8888426","2","8508","PLN-PRA 56019014093NBMB5221840817338040","ESB:NBMB:0400200T:735348999673","","Beli Token PLN 56019014093 via BRImo"
"18","12301083861508","2024-09-19 16:38:32","2024-09-19 00:00:00","163832","128959","BFST18101610149678 NBMB:BTANIDJA 20240919BRINIDJA010O0236668656 ESB:NBMB:0008G00F:736714814134","625200.00","100000.00",".00","525200.00","Db","8888561","2","9973","BFST18101610149678 NBMB:BTANIDJA","ESB:NBMB:0008G00F:736714814134","20240919BRINIDJA010O0236668656","BFST18101610149678 NBMB:BTANIDJA"
"19","12301083861508","2024-09-19 16:38:32","2024-09-19 00:00:00","163832","128959","BFST18101610149678 NBMB:BTANIDJA 20240919BRINIDJA010O0236668656 ESB:NBMB:0008G00F:736714814134","525200.00","2500.00",".00","522700.00","Db","8888561","2","9973","BFST18101610149678 NBMB:BTANIDJA","ESB:NBMB:0008G00F:736714814134","20240919BRINIDJA010O0236668656","BFST18101610149678 NBMB:BTANIDJA"
"20","12301083861508","2024-09-20 00:00:00","2024-09-20 00:00:00","0","0","Biaya Bulanan ATM","522700.00","1000.00",".00","521700.00","Db","","452","","","","","Biaya Bulanan ATM"
"21","12301083861508","2024-09-20 23:59:59","2024-09-20 00:00:00","235959","0","Biaya Administrasi","521700.00","6000.00",".00","515700.00","Db","","453","","","","","Biaya Administrasi"
"22","12301083861508","2024-09-22 12:40:09","2024-09-22 00:00:00","124009","43328","BRIVA88810081286178536NBMBDNID ALUXXXXX BRIVA 88810081286178536NBMBDNID ALUXXXXX ESB:NBMB:0200200P:737832948222","515700.00","50000.00",".00","465700.00","Db","8888213","4","6669","BRIVA88810081286178536NBMBDNID ALUXXXXX","ESB:NBMB:0200200P:737832948222","BRIVA 88810081286178536NBMBDNID ALUXXXXX","Top Up DANA ALUXXXXX 0812xxxx536 via BRImo"
"23","12301083861508","2024-09-23 19:42:51","2024-09-23 00:00:00","194251","7488740","WBNKSTOR439301012167536TO012301083861508 ESB:WBNK:0303A00F:510123048629","465700.00",".00","500000.00","965700.00","Cr","0888122","1","8506","WBNKSTOR439301012167536TO012301083861508","ESB:WBNK:0303A00F:510123048629","","WBNKSTOR439301012167536TO012301083861508"
"24","12301083861508","2024-09-24 14:57:41","2024-09-24 00:00:00","145741","1182662","6013011130242596000000000349","965700.00","300000.00",".00","665700.00","Db","0888300","2","9992","6013011130242596000000000349","","","6013011130242596000000000349"
"25","12301083861508","2024-09-24 14:57:41","2024-09-24 00:00:00","145741","1182662","6013011130242596000000000349","665700.00","7500.00",".00","658200.00","Db","0888300","2","9992","6013011130242596000000000349","","","6013011130242596000000000349"
"26","12301083861508","2024-09-28 19:11:13","2024-09-28 00:00:00","191113","0","081286178536|1SMS|23/09/2024-23/09/2024","658200.00","750.00",".00","657450.00","Db","BRIMDBT","582","","081286178536|1SMS|23/09/2024-23/09/2024","","","Biaya SMS Notifikasi Sejumlah 1 Notifikasi"
"1","12301083861508","2024-10-01 15:34:51","2024-10-01 00:00:00","153451","9068844","BRIVA88810081286178536NBMBDNID ALUXXXXX BRIVA 88810081286178536NBMBDNID ALUXXXXX ESB:NBMB:0200200P:741770742795","657450.00","100000.00",".00","557450.00","Db","8888395","4","6669","BRIVA88810081286178536NBMBDNID ALUXXXXX","ESB:NBMB:0200200P:741770742795","BRIVA 88810081286178536NBMBDNID ALUXXXXX","Top Up DANA ALUXXXXX 0812xxxx536 via BRImo"
"2","12301083861508","2024-10-03 17:16:16","2024-10-03 00:00:00","171616","9027997","PUL-SIM 081286178536NBMB5221840817338040 ESB:NBMB:0100101C:742820551925","557450.00","20000.00",".00","537450.00","Db","8888311","2","8508","PUL-SIM 081286178536NBMB5221840817338040","ESB:NBMB:0100101C:742820551925","","Beli Pulsa Simpati 0812xxxx536 via BRImo"
"3","12301083861508","2024-10-03 17:16:16","2024-10-03 00:00:00","171616","9027997","PUL-SIM 081286178536NBMB5221840817338040 ESB:NBMB:0100101C:742820551925","537450.00","1500.00",".00","535950.00","Db","8888311","2","8508","PUL-SIM 081286178536NBMB5221840817338040","ESB:NBMB:0100101C:742820551925","","Beli Pulsa Simpati 0812xxxx536 via BRImo"
"4","12301083861508","2024-10-13 11:06:15","2024-10-13 00:00:00","110615","8063275","PUL-SIM 081286178536NBMB5221840817338040 ESB:NBMB:0100101C:747039341309","535950.00","20000.00",".00","515950.00","Db","8888038","2","8508","PUL-SIM 081286178536NBMB5221840817338040","ESB:NBMB:0100101C:747039341309","","Beli Pulsa Simpati 0812xxxx536 via BRImo"
"5","12301083861508","2024-10-13 11:06:15","2024-10-13 00:00:00","110615","8063275","PUL-SIM 081286178536NBMB5221840817338040 ESB:NBMB:0100101C:747039341309","515950.00","1500.00",".00","514450.00","Db","8888038","2","8508","PUL-SIM 081286178536NBMB5221840817338040","ESB:NBMB:0100101C:747039341309","","Beli Pulsa Simpati 0812xxxx536 via BRImo"
"6","12301083861508","2024-10-13 11:06:41","2024-10-13 00:00:00","110641","8023269","PUL-SIM 081286178536NBMB5221840817338040 ESB:NBMB:0100101C:747039490198","514450.00","100000.00",".00","414450.00","Db","8888123","2","8508","PUL-SIM 081286178536NBMB5221840817338040","ESB:NBMB:0100101C:747039490198","","Beli Pulsa Simpati 0812xxxx536 via BRImo"
"7","12301083861508","2024-10-13 11:06:41","2024-10-13 00:00:00","110641","8023269","PUL-SIM 081286178536NBMB5221840817338040 ESB:NBMB:0100101C:747039490198","414450.00","1500.00",".00","412950.00","Db","8888123","2","8508","PUL-SIM 081286178536NBMB5221840817338040","ESB:NBMB:0100101C:747039490198","","Beli Pulsa Simpati 0812xxxx536 via BRImo"
"8","12301083861508","2024-10-13 18:18:41","2024-10-13 00:00:00","181841","42756","BFST012301083861508NETI APRIANI:BMRIIDJA 20241013BMRIIDJA010O0225233015 ESB:BFST:0008N:20241013FASTIDJA010460736","412950.00",".00","500000.00","912950.00","Cr","8888656","1","8154","BFST012301083861508NETI APRIANI:BMRIIDJA","ESB:BFST:0008N:20241013FASTIDJA010460736","20241013BMRIIDJA010O0225233015","BFST012301083861508NETI APRIANI:BMRIIDJA"
"9","12301083861508","2024-10-14 10:57:44","2024-10-14 00:00:00","105744","8023649","BRIVA88810081224947169NBMBDNID FITXX AKM BRIVA 88810081224947169NBMBDNID FITXX AK ESB:NBMB:0200200P:747424319086","912950.00","55000.00",".00","857950.00","Db","8888231","4","6669","BRIVA88810081224947169NBMBDNID FITXX AKM","ESB:NBMB:0200200P:747424319086","BRIVA 88810081224947169NBMBDNID FITXX AK","Top Up DANA FITXX AKM 0812xxxx169 via BRImo"
"10","12301083861508","2024-10-14 11:09:47","2024-10-14 00:00:00","110947","8043777","BRIVA88810081285686759NBMBDNID ARFXXX HA BRIVA 88810081285686759NBMBDNID ARFXXX H ESB:NBMB:0200200P:747429326892","857950.00","90000.00",".00","767950.00","Db","8888602","4","6669","BRIVA88810081285686759NBMBDNID ARFXXX HA","ESB:NBMB:0200200P:747429326892","BRIVA 88810081285686759NBMBDNID ARFXXX H","Top Up DANA ARFXXX HA 0812xxxx759 via BRImo"
"11","12301083861508","2024-10-17 11:45:07","2024-10-17 00:00:00","114507","23349","NBMB TEDI ALAMSYAH TO ALUSTINA SUCI MAN ESB:NBMB:0001500F:748734335247","767950.00",".00","20000.00","787950.00","Cr","8888123","1","8506","NBMB TEDI ALAMSYAH TO ALUSTINA SUCI MAN","ESB:NBMB:0001500F:748734335247","","Transfer Dari Tedi Alamsyah via BRImo"
"12","12301083861508","2024-10-17 21:01:19","2024-10-17 00:00:00","210119","8070256","BRIVA88810081286178536NBMBDNID ALUXXXXX BRIVA 88810081286178536NBMBDNID ALUXXXXX ESB:NBMB:0200200P:748963990297","787950.00","50000.00",".00","737950.00","Db","8888106","4","6669","BRIVA88810081286178536NBMBDNID ALUXXXXX","ESB:NBMB:0200200P:748963990297","BRIVA 88810081286178536NBMBDNID ALUXXXXX","Top Up DANA ALUXXXXX 0812xxxx536 via BRImo"
"13","12301083861508","2024-10-19 16:50:37","2024-10-19 00:00:00","165037","1644431","6013011130242596000000000624","737950.00","100000.00",".00","637950.00","Db","0888294","2","9992","6013011130242596000000000624","","","6013011130242596000000000624"
"14","12301083861508","2024-10-19 16:50:37","2024-10-19 00:00:00","165037","1644431","6013011130242596000000000624","637950.00","7500.00",".00","630450.00","Db","0888294","2","9992","6013011130242596000000000624","","","6013011130242596000000000624"
"15","12301083861508","2024-10-20 00:00:00","2024-10-20 00:00:00","0","0","Monthly Fee ATM","630450.00","1000.00",".00","629450.00","Db","","452","","","","","Monthly Fee ATM"
"16","12301083861508","2024-10-20 06:23:25","2024-10-20 00:00:00","62325","5057004","PLN-PRA 56019014093NBMB5221840817338040 ESB:NBMB:20006PLN:749902127190","629450.00","50000.00",".00","579450.00","Db","8888338","2","8508","PLN-PRA 56019014093NBMB5221840817338040","ESB:NBMB:20006PLN:749902127190","","Beli Token PLN 56019014093 via BRImo"
"17","12301083861508","2024-10-20 06:23:25","2024-10-20 00:00:00","62325","5057004","PLN-PRA 56019014093NBMB5221840817338040 ESB:NBMB:20006PLN:749902127190","579450.00","3000.00",".00","576450.00","Db","8888338","2","8508","PLN-PRA 56019014093NBMB5221840817338040","ESB:NBMB:20006PLN:749902127190","","Beli Token PLN 56019014093 via BRImo"
"18","12301083861508","2024-10-20 08:10:38","2024-10-20 00:00:00","81038","141520","BFST012301083861508RIZAL ABROR :SYCAIDJ1 20241020SYCAIDJ1010O9904363182 ESB:BFST:0008N:20241020FASTIDJA010059742","576450.00",".00","15000.00","591450.00","Cr","8888632","1","8154","BFST012301083861508RIZAL ABROR :SYCAIDJ1","ESB:BFST:0008N:20241020FASTIDJA010059742","20241020SYCAIDJ1010O9904363182","BFST012301083861508RIZAL ABROR :SYCAIDJ1"
"19","12301083861508","2024-10-20 19:08:24","2024-10-20 00:00:00","190824","126255","BRIVA88810085214035324NBMBDNID LUTXXX SI BRIVA 88810085214035324NBMBDNID LUTXXX S ESB:NBMB:0200200P:750148493209","591450.00","80000.00",".00","511450.00","Db","8888539","4","6669","BRIVA88810085214035324NBMBDNID LUTXXX SI","ESB:NBMB:0200200P:750148493209","BRIVA 88810085214035324NBMBDNID LUTXXX S","Top Up DANA LUTXXX SI 0852xxxx324 via BRImo"
"20","12301083861508","2024-10-20 23:59:59","2024-10-20 00:00:00","235959","0","Admin Fee","511450.00","6000.00",".00","505450.00","Db","","453","","","","","Admin Fee"
"21","12301083861508","2024-10-21 10:36:32","2024-10-21 00:00:00","103632","8023430","BRIVA88810081286178536NBMBDNID ALUXXXXX BRIVA 88810081286178536NBMBDNID ALUXXXXX ESB:NBMB:0200200P:750367325665","505450.00","20000.00",".00","485450.00","Db","8888372","4","6669","BRIVA88810081286178536NBMBDNID ALUXXXXX","ESB:NBMB:0200200P:750367325665","BRIVA 88810081286178536NBMBDNID ALUXXXXX","Top Up DANA ALUXXXXX 0812xxxx536 via BRImo"
"22","12301083861508","2024-10-22 18:06:38","2024-10-22 00:00:00","180638","0","081286178536|1SMS|13/10/2024-13/10/2024","485450.00","750.00",".00","484700.00","Db","BRIMDBT","582","","081286178536|1SMS|13/10/2024-13/10/2024","","","Biaya SMS Notifikasi Sejumlah 1 Notifikasi"
"23","12301083861508","2024-10-23 18:20:38","2024-10-23 00:00:00","182038","108128","BFST012301083861508NETI APRIANI:BMRIIDJA 20241023BMRIIDJA010O0224670424 ESB:BFST:0008N:20241023FASTIDJA010157050","484700.00",".00","1000000.00","1484700.00","Cr","8888690","1","8154","BFST012301083861508NETI APRIANI:BMRIIDJA","ESB:BFST:0008N:20241023FASTIDJA010157050","20241023BMRIIDJA010O0224670424","BFST012301083861508NETI APRIANI:BMRIIDJA"
"24","12301083861508","2024-10-24 10:58:14","2024-10-24 00:00:00","105814","142700","BRIVA88810081286178536NBMBDNID ALUXXXXX BRIVA 88810081286178536NBMBDNID ALUXXXXX ESB:NBMB:0200200P:751633214846","1484700.00","100000.00",".00","1384700.00","Db","8888162","4","6669","BRIVA88810081286178536NBMBDNID ALUXXXXX","ESB:NBMB:0200200P:751633214846","BRIVA 88810081286178536NBMBDNID ALUXXXXX","Top Up DANA ALUXXXXX 0812xxxx536 via BRImo"
"25","12301083861508","2024-10-25 13:09:08","2024-10-25 00:00:00","130908","788949","6013011130242596000000004879","1384700.00","200000.00",".00","1184700.00","Db","0888335","2","9992","6013011130242596000000004879","","","6013011130242596000000004879"
"26","12301083861508","2024-10-28 19:11:09","2024-10-28 00:00:00","191109","0","081286178536|1SMS|23/10/2024-23/10/2024","1184700.00","750.00",".00","1183950.00","Db","BRIMDBT","582","","081286178536|1SMS|23/10/2024-23/10/2024","","","Biaya SMS Notifikasi Sejumlah 1 Notifikasi"
1,12301083861508,2024-11-02 07:00:00,11/2/2024 0:00,70056,61330,BFST0113340691100 NBMB:PDJBIDJA 20241102BRINIDJA010O0226093501 ESB:NBMB:0008G00F:755683568121,1183950,680000,0,503950,Db,8888286,2,9973,BFST0113340691100 NBMB:PDJBIDJA,ESB:NBMB:0008G00F:755683568121,20241102BRINIDJA010O0226093501,BFST0113340691100 NBMB:PDJBIDJA
2,12301083861508,2024-11-02 07:00:04,11/2/2024 0:00,70056,61330,BFST0113340691100 NBMB:PDJBIDJA 20241102BRINIDJA010O0226093501 ESB:NBMB:0008G00F:755683568121,503950,2500,0,501450,Db,8888286,2,9973,BFST0113340691100 NBMB:PDJBIDJA,ESB:NBMB:0008G00F:755683568121,20241102BRINIDJA010O0226093501,BFST0113340691100 NBMB:PDJBIDJA
3,12301083861508,2024-11-02 13:30:00,11/2/2024 0:00,133028,7143482,DANA20241102019488604086NAJMAALFISYA WS_OB;20241102019488604086;72133 ESB:T:0371860:S:0371892:WSOB,501450,0,100000,601450,Cr,371860,5,8700,DANA20241102019488604086NAJMAALFISYA,ESB:T:0371860:S:0371892:WSOB,WS_OB;20241102019488604086;72133,DANA20241102019488604086NAJMAALFISYA
4,12301083861508,2024-11-04 18:40:00,11/4/2024 0:00,184057,7699,BRIVA88810081219170019NBMBDNID NAJXX ALF BRIVA 88810081219170019NBMBDNID NAJXX AL ESB:NBMB:0200200P:756856666802,601450,40000,0,561450,Db,8888145,4,6669,BRIVA88810081219170019NBMBDNID NAJXX ALF,ESB:NBMB:0200200P:756856666802,BRIVA 88810081219170019NBMBDNID NAJXX AL,Top Up DANA NAJXX ALF 0812xxxx019 via BRImo
5,12301083861508,2024-11-04 19:26:00,11/4/2024 0:00,192614,0,081286178536|1SMS|02/11/2024-02/11/2024,561450,750,0,560700,Db,BRIMDBT,582,,081286178536|1SMS|02/11/2024-02/11/2024,,,Biaya SMS Notifikasi Sejumlah 1 Notifikasi
6,12301083861508,2024-11-07 18:02:00,11/7/2024 0:00,180229,166953,BRIVA88810081286178536NBMBDNID ALUXXXXX BRIVA 88810081286178536NBMBDNID ALUXXXXX ESB:NBMB:0200200P:758211987117,560700,50000,0,510700,Db,8888215,4,6669,BRIVA88810081286178536NBMBDNID ALUXXXXX,ESB:NBMB:0200200P:758211987117,BRIVA 88810081286178536NBMBDNID ALUXXXXX,Top Up DANA ALUXXXXX 0812xxxx536 via BRImo
7,12301083861508,2024-11-07 06:43:00,11/12/2024 0:00,64343,8001217,PUL-SIM 081286178536NBMB5221840817338040 ESB:NBMB:0100101C:760125197924,510700,100000,0,410700,Db,8888468,2,8508,PUL-SIM 081286178536NBMB5221840817338040,ESB:NBMB:0100101C:760125197924,,Beli Pulsa Simpati 0812xxxx536 via BRImo
8,12301083861508,2024-11-12 06:43:04,11/12/2024 0:00,64343,8001217,PUL-SIM 081286178536NBMB5221840817338040 ESB:NBMB:0100101C:760125197924,410700,1500,0,409200,Db,8888468,2,8508,PUL-SIM 081286178536NBMB5221840817338040,ESB:NBMB:0100101C:760125197924,,Beli Pulsa Simpati 0812xxxx536 via BRImo
9,12301083861508,2024-11-12 06:44:00,11/12/2024 0:00,64402,8021187,PUL-SIM 081286178536NBMB5221840817338040 ESB:NBMB:0100101C:760125266493,409200,20000,0,389200,Db,8888445,2,8508,PUL-SIM 081286178536NBMB5221840817338040,ESB:NBMB:0100101C:760125266493,,Beli Pulsa Simpati 0812xxxx536 via BRImo
10,12301083861508,2024-11-12 06:44:04,11/12/2024 0:00,64402,8021187,PUL-SIM 081286178536NBMB5221840817338040 ESB:NBMB:0100101C:760125266493,389200,1500,0,387700,Db,8888445,2,8508,PUL-SIM 081286178536NBMB5221840817338040,ESB:NBMB:0100101C:760125266493,,Beli Pulsa Simpati 0812xxxx536 via BRImo
11,12301083861508,2024-11-12 22:13:00,11/12/2024 0:00,221332,74997,BFST012301083861508CAHYA NURLEL:BMRIIDJA 20241112BMRIIDJA010O0220698454 ESB:BFST:0008N:20241112FASTIDJA01057268878,387700,0,40000,427700,Cr,8888705,1,8154,BFST012301083861508CAHYA NURLEL:BMRIIDJA,ESB:BFST:0008N:20241112FASTIDJA01057268878,20241112BMRIIDJA010O0220698454,BFST012301083861508CAHYA NURLEL:BMRIIDJA
12,12301083861508,2024-11-13 17:38:00,11/13/2024 0:00,173839,7126591,DANA20241113019652975401ALUSTINASUCI WS_OB;20241113019652975401;72133 ESB:T:0371858:S:0371892:WSOB,427700,0,50000,477700,Cr,371858,5,8700,DANA20241113019652975401ALUSTINASUCI,ESB:T:0371858:S:0371892:WSOB,WS_OB;20241113019652975401;72133,DANA20241113019652975401ALUSTINASUCI
13,12301083861508,2024-11-14 17:25:00,11/14/2024 0:00,172508,8007740,BRIVA88810081286178536NBMBDNID ALUXXXXX BRIVA 88810081286178536NBMBDNID ALUXXXXX ESB:NBMB:0200200P:761220987253,477700,30000,0,447700,Db,8888582,4,6669,BRIVA88810081286178536NBMBDNID ALUXXXXX,ESB:NBMB:0200200P:761220987253,BRIVA 88810081286178536NBMBDNID ALUXXXXX,Top Up DANA ALUXXXXX 0812xxxx536 via BRImo
14,12301083861508,2024-11-15 21:36:00,11/15/2024 0:00,213650,128653,BRIVA88810081779248728NBMBDNID GRAXXXX M BRIVA 88810081779248728NBMBDNID GRAXXXX ESB:NBMB:0200200P:761768826232,447700,20000,0,427700,Db,8888190,4,6669,BRIVA88810081779248728NBMBDNID GRAXXXX M,ESB:NBMB:0200200P:761768826232,BRIVA 88810081779248728NBMBDNID GRAXXXX,Top Up DANA GRAXXXX M 0817xxxx728 via BRImo
15,12301083861508,2024-11-15 21:50:00,11/15/2024 0:00,215043,7008180,DANA20241115019682597995ERIEJUWITA WS_OB;20241115019682597995;72133 ESB:T:0371877:S:0371892:WSOB,427700,0,300000,727700,Cr,371877,5,8700,DANA20241115019682597995ERIEJUWITA,ESB:T:0371877:S:0371892:WSOB,WS_OB;20241115019682597995;72133,DANA20241115019682597995ERIEJUWITA
16,12301083861508,2024-11-15 20:33:00,11/18/2024 0:00,203338,68398,NBMB ALUSTINA SUCI TO TEDI ALAMSYAH ESB:NBMB:0001500F:763041547081,727700,90000,0,637700,Db,8888358,2,8506,NBMB ALUSTINA SUCI TO TEDI ALAMSYAH,ESB:NBMB:0001500F:763041547081,,Transfer Ke Tedi Alamsyah via BRImo
